date,state,beds,beds_covid,beds_noncrit,admitted_pui,admitted_covid,admitted_total,discharged_pui,discharged_covid,discharged_total,hosp_covid,hosp_pui,hosp_noncovid
1/1/2021,Johor,3162,705,3079,17,106,123,4,38,42,481,55,71
1/1/2021,Kedah,1298,213,1265,9,12,21,0,25,25,92,18,828
1/1/2021,Kelantan,1498,378,1425,2,44,46,4,15,19,232,4,927
1/1/2021,Melaka,1091,187,1039,2,7,9,4,9,13,88,10,767
1/1/2021,Negeri Sembilan,1331,633,1309,1,26,27,0,33,33,292,2,605
1/1/2021,Pahang,1889,236,1836,6,19,25,1,16,17,87,10,885
1/1/2021,Perak,2619,341,2549,1,25,26,2,12,14,118,17,1476
1/1/2021,Perlis,495,29,482,7,0,7,6,1,7,0,17,279
1/1/2021,Pulau Pinang,1292,148,1251,0,36,36,0,6,6,125,0,769
1/1/2021,Sabah,2790,1189,2656,17,79,96,25,52,77,574,108,1090
1/1/2021,Sarawak,2390,328,2319,24,8,32,26,0,26,22,36,1551
1/1/2021,Selangor,887,630,827,14,127,141,13,132,145,491,28,15
1/1/2021,Terengganu,1202,179,1179,7,23,30,5,3,8,44,20,775
1/1/2021,W.P. Kuala Lumpur,3154,937,3011,7,34,41,5,84,89,328,17,1405
1/1/2021,W.P. Labuan,122,25,112,0,3,3,1,1,2,10,4,50
2/1/2021,Johor,3162,705,3079,9,156,165,6,63,69,500,48,104
2/1/2021,Kedah,1298,213,1265,3,29,32,1,23,24,107,11,814
2/1/2021,Kelantan,1498,378,1425,0,50,50,4,21,25,253,0,780
2/1/2021,Melaka,1091,187,1039,5,46,51,4,10,14,124,15,732
2/1/2021,Negeri Sembilan,1331,633,1309,0,68,68,1,32,33,309,1,566
2/1/2021,Pahang,1889,236,1836,2,17,19,6,11,17,93,6,909
2/1/2021,Perak,2619,341,2549,3,9,12,1,12,13,116,15,1377
2/1/2021,Perlis,495,29,482,2,1,3,3,0,3,1,15,266
2/1/2021,Pulau Pinang,1292,148,1251,0,33,33,0,14,14,126,0,752
2/1/2021,Sabah,2790,1189,2656,15,97,112,28,69,97,566,92,1035
2/1/2021,Sarawak,2390,328,2319,23,6,29,17,2,19,25,41,1554
2/1/2021,Selangor,887,630,827,9,100,109,3,108,111,486,30,17
2/1/2021,Terengganu,1202,179,1179,8,9,17,6,4,10,49,22,770
2/1/2021,W.P. Kuala Lumpur,3154,949,3011,14,41,55,1,87,88,273,29,1280
2/1/2021,W.P. Labuan,122,25,112,0,0,0,0,2,2,7,4,47
3/1/2021,Johor,3162,705,3079,5,94,99,6,46,52,518,50,109
3/1/2021,Kedah,1298,213,1265,7,39,46,0,11,11,108,18,827
3/1/2021,Kelantan,1498,409,1425,2,25,27,0,23,23,251,2,787
3/1/2021,Melaka,1091,187,1039,2,7,9,0,6,6,125,17,715
3/1/2021,Negeri Sembilan,1331,633,1309,2,88,90,0,35,35,356,3,575
3/1/2021,Pahang,1889,236,1836,3,30,33,4,18,22,104,5,859
3/1/2021,Perak,2619,341,2549,1,33,34,1,9,10,135,18,1339
3/1/2021,Perlis,495,29,482,3,0,3,6,0,6,1,12,274
3/1/2021,Pulau Pinang,1292,148,1251,0,28,28,0,11,11,127,0,751
3/1/2021,Sabah,2790,1189,2656,37,118,155,19,64,83,588,107,1090
3/1/2021,Sarawak,2390,328,2319,22,7,29,20,0,20,31,44,1559
3/1/2021,Selangor,887,630,827,6,145,151,7,126,133,505,26,17
3/1/2021,Terengganu,1202,179,1179,1,13,14,4,4,8,58,19,836
3/1/2021,W.P. Kuala Lumpur,3154,949,3011,9,58,67,1,46,47,271,32,1280
3/1/2021,W.P. Labuan,122,25,112,1,0,1,0,1,1,9,6,47
4/1/2021,Johor,3162,705,3079,10,95,105,10,48,58,474,40,107
4/1/2021,Kedah,1298,213,1265,12,52,64,2,37,39,132,18,829
4/1/2021,Kelantan,1498,409,1425,5,30,35,0,19,19,265,7,785
4/1/2021,Melaka,1091,187,1039,4,18,22,7,14,21,128,13,738
4/1/2021,Negeri Sembilan,1331,633,1309,4,71,75,0,23,23,373,7,527
4/1/2021,Pahang,1889,236,1836,4,20,24,2,8,10,116,7,895
4/1/2021,Perak,2619,341,2549,3,17,20,3,17,20,130,13,1398
4/1/2021,Perlis,495,29,482,2,0,2,3,0,3,3,9,287
4/1/2021,Pulau Pinang,1292,179,1251,0,27,27,0,8,8,143,0,782
4/1/2021,Sabah,2790,1189,2656,29,115,144,24,30,54,613,109,1144
4/1/2021,Sarawak,2390,328,2319,29,10,39,28,0,28,30,46,1636
4/1/2021,Selangor,887,630,827,2,106,108,8,114,122,497,16,17
4/1/2021,Terengganu,1202,179,1179,2,5,7,2,3,5,60,19,835
4/1/2021,W.P. Kuala Lumpur,3154,949,3011,11,59,70,8,26,34,281,29,1360
4/1/2021,W.P. Labuan,122,25,112,3,0,3,0,0,0,7,8,57
5/1/2021,Johor,3162,705,3079,6,142,148,5,27,32,522,40,109
5/1/2021,Kedah,1298,213,1265,12,39,51,1,9,10,153,22,855
5/1/2021,Kelantan,1498,409,1425,1,38,39,3,59,62,242,5,794
5/1/2021,Melaka,1091,187,1039,4,27,31,2,15,17,139,15,774
5/1/2021,Negeri Sembilan,1331,633,1309,0,70,70,1,30,31,423,6,536
5/1/2021,Pahang,1889,236,1836,2,33,35,4,17,21,132,5,989
5/1/2021,Perak,2619,341,2549,1,11,12,2,12,14,122,13,1495
5/1/2021,Perlis,495,29,482,4,1,5,3,0,3,4,10,303
5/1/2021,Pulau Pinang,1292,179,1251,0,32,32,0,6,6,166,0,859
5/1/2021,Sabah,2790,1189,2656,36,101,137,25,38,63,624,113,1196
5/1/2021,Sarawak,2390,328,2319,32,13,45,19,8,27,26,59,1718
5/1/2021,Selangor,887,630,827,6,137,143,9,130,139,501,11,17
5/1/2021,Terengganu,1202,179,1179,5,6,11,4,0,4,66,18,898
5/1/2021,W.P. Kuala Lumpur,3154,949,3011,6,66,72,1,67,68,287,25,1386
5/1/2021,W.P. Labuan,122,25,112,0,1,1,0,2,2,6,4,57
6/1/2021,Johor,3162,705,3079,12,135,147,6,60,66,554,42,102
6/1/2021,Kedah,1298,213,1265,12,29,41,2,31,33,165,21,870
6/1/2021,Kelantan,1498,409,1425,1,28,29,5,33,38,237,2,817
6/1/2021,Melaka,1091,187,1039,11,22,33,7,38,45,121,19,796
6/1/2021,Negeri Sembilan,1331,633,1309,4,70,74,3,48,51,392,5,636
6/1/2021,Pahang,1889,236,1836,2,18,20,1,18,19,132,6,1045
6/1/2021,Perak,2619,341,2549,2,15,17,2,11,13,121,13,1578
6/1/2021,Perlis,495,29,482,3,0,3,3,0,3,4,10,311
6/1/2021,Pulau Pinang,1292,179,1251,0,29,29,0,15,15,165,0,897
6/1/2021,Sabah,2790,1189,2656,31,114,145,18,60,78,608,121,1144
6/1/2021,Sarawak,2390,328,2319,34,5,39,25,1,26,29,69,1760
6/1/2021,Selangor,887,630,827,5,148,153,2,140,142,508,13,16
6/1/2021,Terengganu,1202,179,1179,0,11,11,5,7,12,70,13,836
6/1/2021,W.P. Kuala Lumpur,3154,963,3091,3,61,64,2,25,27,296,20,1457
6/1/2021,W.P. Labuan,122,25,112,0,0,0,1,1,2,6,3,69
7/1/2021,Johor,3162,705,3079,8,139,147,7,83,90,532,38,119
7/1/2021,Kedah,1298,213,1265,21,13,34,0,45,45,141,34,852
7/1/2021,Kelantan,1498,409,1425,4,46,50,1,62,63,221,5,832
7/1/2021,Melaka,1091,187,1039,3,23,26,4,7,11,137,18,745
7/1/2021,Negeri Sembilan,1331,633,1309,4,58,62,1,43,44,393,10,627
7/1/2021,Pahang,1889,236,1836,0,18,18,3,18,21,132,3,1020
7/1/2021,Perak,2619,341,2549,8,30,38,3,9,12,138,21,1590
7/1/2021,Perlis,495,29,482,2,0,2,2,0,2,4,9,281
7/1/2021,Pulau Pinang,1292,179,1251,0,17,17,0,14,14,166,0,766
7/1/2021,Sabah,2790,1171,2656,14,119,133,33,56,89,649,97,1179
7/1/2021,Sarawak,2390,328,2319,28,9,37,40,2,42,35,59,1788
7/1/2021,Selangor,887,630,827,4,112,116,0,118,118,501,16,17
7/1/2021,Terengganu,1202,193,1179,8,15,23,0,15,15,68,23,815
7/1/2021,W.P. Kuala Lumpur,3154,583,3091,3,68,71,2,42,44,301,25,1481
7/1/2021,W.P. Labuan,122,25,112,0,0,0,0,1,1,5,3,68
8/1/2021,Johor,3162,705,3079,2,189,191,6,94,100,584,86,112
8/1/2021,Kedah,1298,213,1265,8,13,21,4,23,27,141,24,795
8/1/2021,Kelantan,1498,409,1425,4,55,59,3,99,102,177,6,744
8/1/2021,Melaka,1091,187,1039,4,29,33,3,24,27,142,19,749
8/1/2021,Negeri Sembilan,1331,633,1309,0,64,64,0,48,48,392,8,617
8/1/2021,Pahang,1889,236,1836,4,14,18,0,15,15,131,7,984
8/1/2021,Perak,2619,341,2549,5,7,12,0,4,4,136,58,1599
8/1/2021,Perlis,495,29,482,7,5,12,2,0,2,9,11,293
8/1/2021,Pulau Pinang,1292,179,1251,0,39,39,0,27,27,162,0,803
8/1/2021,Sabah,2790,1171,2656,13,99,112,25,61,86,628,81,1133
8/1/2021,Sarawak,2390,328,2319,30,14,44,23,6,29,34,74,1776
8/1/2021,Selangor,887,630,827,7,145,152,6,122,128,527,13,18
8/1/2021,Terengganu,1231,208,1208,7,33,40,2,15,17,86,26,844
8/1/2021,W.P. Kuala Lumpur,3154,583,3091,6,61,67,2,48,50,310,24,1436
8/1/2021,W.P. Labuan,122,25,112,2,2,4,0,0,0,7,5,71
9/1/2021,Johor,3162,705,3079,2,190,192,7,93,100,584,86,108
9/1/2021,Kedah,1298,213,1265,19,34,53,2,15,17,155,34,803
9/1/2021,Kelantan,1493,409,1420,2,39,41,3,12,15,203,5,714
9/1/2021,Melaka,1091,187,1039,6,9,15,1,19,20,130,24,671
9/1/2021,Negeri Sembilan,1331,633,1309,0,71,71,3,36,39,396,5,591
9/1/2021,Pahang,1889,236,1836,0,21,21,4,28,32,124,3,988
9/1/2021,Perak,2619,341,2549,0,9,9,0,12,12,154,44,1512
9/1/2021,Perlis,495,29,482,4,8,12,4,0,4,11,6,301
9/1/2021,Pulau Pinang,1292,179,1251,0,24,24,0,21,21,151,0,803
9/1/2021,Sabah,2790,1171,2656,40,82,122,26,95,121,553,94,1177
9/1/2021,Sarawak,2390,328,2319,23,16,39,31,3,34,33,65,1724
9/1/2021,Selangor,887,630,827,12,124,136,3,135,138,518,19,16
9/1/2021,Terengganu,1231,208,1208,6,14,20,11,10,21,90,29,802
9/1/2021,W.P. Kuala Lumpur,3154,583,3091,2,57,59,0,56,56,298,24,1263
9/1/2021,W.P. Labuan,122,25,112,0,2,2,3,0,3,9,2,67
10/1/2021,Johor,3162,705,3079,37,119,156,1,21,22,554,65,74
10/1/2021,Kedah,1298,213,1265,5,29,34,0,38,38,161,25,819
10/1/2021,Kelantan,1493,409,1420,2,35,37,1,30,31,209,6,790
10/1/2021,Melaka,1091,187,1039,1,30,31,3,22,25,184,20,804
10/1/2021,Negeri Sembilan,1331,633,1309,0,61,61,2,38,40,412,3,549
10/1/2021,Pahang,1889,236,1836,2,34,36,1,11,12,147,4,952
10/1/2021,Perak,2619,341,2549,5,33,38,2,22,24,161,39,1490
10/1/2021,Perlis,495,29,482,9,3,12,1,0,1,11,14,294
10/1/2021,Pulau Pinang,1292,179,1251,0,30,30,0,16,16,156,0,748
10/1/2021,Sabah,2790,1171,2656,22,105,127,21,50,71,606,94,1102
10/1/2021,Sarawak,2390,410,2319,51,37,88,18,2,20,48,97,1684
10/1/2021,Selangor,887,630,827,8,155,163,4,153,157,523,19,15
10/1/2021,Terengganu,1231,208,1208,6,11,17,6,14,20,88,28,854
10/1/2021,W.P. Kuala Lumpur,3154,583,3091,7,45,52,3,36,39,292,25,1203
10/1/2021,W.P. Labuan,122,25,112,1,1,2,0,0,0,10,3,65
11/1/2021,Johor,3162,705,3079,14,186,200,7,112,119,526,66,77
11/1/2021,Kedah,1298,213,1265,17,53,70,3,40,43,181,32,854
11/1/2021,Kelantan,1493,409,1420,0,51,51,4,40,44,220,2,816
11/1/2021,Melaka,1091,187,1039,6,28,34,8,15,23,163,20,721
11/1/2021,Negeri Sembilan,1331,633,1309,0,67,67,0,39,39,423,3,546
11/1/2021,Pahang,1889,611,1836,7,39,46,2,18,20,159,9,921
11/1/2021,Perak,2619,341,2549,10,27,37,3,15,18,163,44,1540
11/1/2021,Perlis,495,29,482,1,1,2,0,0,0,11,13,318
11/1/2021,Pulau Pinang,1292,224,1249,0,32,32,0,22,22,191,0,755
11/1/2021,Sabah,2790,1171,2656,16,107,123,13,37,50,657,89,1145
11/1/2021,Sarawak,2390,410,2319,34,59,93,36,4,40,98,91,1721
11/1/2021,Selangor,887,630,827,4,119,123,4,96,100,544,18,19
11/1/2021,Terengganu,1231,208,1208,15,22,37,3,11,14,103,35,850
11/1/2021,W.P. Kuala Lumpur,3154,583,3091,9,46,55,0,36,36,299,23,1262
11/1/2021,W.P. Labuan,122,25,112,1,2,3,1,1,2,11,3,78
12/1/2021,Johor,3162,705,3079,9,235,244,5,52,57,605,58,77
12/1/2021,Kedah,1298,213,1265,20,14,34,2,54,56,180,31,859
12/1/2021,Kelantan,1493,409,1420,2,33,35,1,22,23,217,3,834
12/1/2021,Melaka,1091,187,1039,6,20,26,8,15,23,171,27,712
12/1/2021,Negeri Sembilan,1331,633,1309,2,60,62,0,36,36,425,4,626
12/1/2021,Pahang,1889,611,1836,3,41,44,1,27,28,174,10,928
12/1/2021,Perak,2619,341,2549,3,13,16,5,31,36,140,41,1590
12/1/2021,Perlis,495,29,482,0,0,0,2,0,2,10,11,329
12/1/2021,Pulau Pinang,1292,224,1249,0,33,33,0,28,28,187,0,773
12/1/2021,Sabah,2790,1188,2656,30,121,151,24,56,80,695,88,1139
12/1/2021,Sarawak,2708,579,2637,39,115,154,38,18,56,165,96,1756
12/1/2021,Selangor,887,630,827,3,137,140,7,146,153,537,10,17
12/1/2021,Terengganu,1231,212,1208,8,21,29,3,14,17,111,39,796
12/1/2021,W.P. Kuala Lumpur,3154,583,3091,6,60,66,3,40,43,305,15,1292
12/1/2021,W.P. Labuan,122,25,112,1,0,1,0,2,2,9,4,81
13/1/2021,Johor,3162,708,3081,25,176,201,8,71,79,559,72,80
13/1/2021,Kedah,1298,213,1265,12,49,61,1,74,75,182,22,837
13/1/2021,Kelantan,1573,433,1500,1,72,73,1,23,24,262,3,811
13/1/2021,Melaka,1091,243,1039,6,25,31,1,34,35,138,26,751
13/1/2021,Negeri Sembilan,1331,633,1309,0,72,72,0,30,30,448,4,659
13/1/2021,Pahang,2170,701,2117,3,25,28,2,18,20,217,13,1055
13/1/2021,Perak,2619,341,2549,5,25,30,1,4,5,157,49,1560
13/1/2021,Perlis,495,32,482,6,0,6,2,0,2,10,14,337
13/1/2021,Pulau Pinang,1292,224,1249,0,34,34,0,19,19,197,0,773
13/1/2021,Sabah,2942,1217,2808,21,112,133,15,69,84,679,88,1133
13/1/2021,Sarawak,2708,579,2637,44,76,120,31,4,35,152,75,1375
13/1/2021,Selangor,887,630,827,3,101,104,5,157,162,480,7,15
13/1/2021,Terengganu,1231,212,1208,8,14,22,3,22,25,103,38,888
13/1/2021,W.P. Kuala Lumpur,3154,583,3091,11,268,279,4,40,44,322,17,1274
13/1/2021,W.P. Labuan,122,25,112,0,0,0,0,1,1,8,1,79
14/1/2021,Johor,3162,708,3081,23,150,173,10,69,79,588,77,73
14/1/2021,Kedah,1298,213,1265,6,59,65,1,47,48,206,15,814
14/1/2021,Kelantan,1573,433,1500,2,48,50,1,41,42,278,4,812
14/1/2021,Melaka,1091,243,1039,12,39,51,3,13,16,164,35,722
14/1/2021,Negeri Sembilan,1331,633,1309,1,63,64,0,70,70,418,5,597
14/1/2021,Pahang,2170,701,2117,6,36,42,3,29,32,224,17,1051
14/1/2021,Perak,2619,341,2549,5,29,34,3,16,19,172,47,1629
14/1/2021,Perlis,495,32,482,2,3,5,5,0,5,13,10,332
14/1/2021,Pulau Pinang,1292,224,1249,2,41,43,1,36,37,203,3,801
14/1/2021,Sabah,2942,1217,2808,23,97,120,24,54,78,693,85,1161
14/1/2021,Sarawak,2708,579,2637,57,98,155,27,12,39,217,114,1882
14/1/2021,Selangor,887,630,827,10,165,175,2,140,142,504,12,16
14/1/2021,Terengganu,1231,212,1208,5,9,14,6,17,23,95,35,764
14/1/2021,W.P. Kuala Lumpur,3154,595,3091,4,60,64,0,79,79,304,19,1263
14/1/2021,W.P. Labuan,122,25,112,3,1,4,0,3,3,6,4,74
15/1/2021,Johor,3162,708,3081,11,188,199,10,103,113,597,70,72
15/1/2021,Kedah,1924,273,1873,13,53,66,0,51,51,215,22,881
15/1/2021,Kelantan,1573,402,1500,1,40,41,4,45,49,272,1,778
15/1/2021,Melaka,1091,243,1039,1,25,26,0,26,26,155,23,720
15/1/2021,Negeri Sembilan,1331,633,1309,2,51,53,0,47,47,411,7,574
15/1/2021,Pahang,2170,701,2113,1,26,27,1,53,54,197,17,1084
15/1/2021,Perak,2619,341,2549,3,23,26,3,11,14,168,49,1644
15/1/2021,Perlis,508,57,495,5,0,5,4,0,4,12,12,323
15/1/2021,Pulau Pinang,1292,224,1249,0,26,26,0,35,35,185,0,758
15/1/2021,Sabah,2942,1214,2808,28,138,166,20,143,163,711,89,1229
15/1/2021,Sarawak,2708,579,2637,52,98,150,37,7,44,216,127,1907
15/1/2021,Selangor,887,630,827,8,107,115,7,111,118,500,11,17
15/1/2021,Terengganu,1307,268,1284,3,15,18,7,12,19,98,32,695
15/1/2021,W.P. Kuala Lumpur,3154,595,3091,10,84,94,8,50,58,330,16,1243
15/1/2021,W.P. Labuan,122,25,112,0,0,0,0,0,0,6,4,72
16/1/2021,Johor,3162,712,3081,10,171,181,11,62,73,565,66,79
16/1/2021,Kedah,1924,273,1873,8,57,65,0,53,53,263,20,1279
16/1/2021,Kelantan,1573,402,1500,4,39,43,1,37,38,273,4,762
16/1/2021,Melaka,1091,243,1039,7,16,23,3,23,26,148,27,725
16/1/2021,Negeri Sembilan,1331,633,1309,4,73,77,5,62,67,400,6,539
16/1/2021,Pahang,2170,701,2113,1,32,33,6,40,46,189,12,1051
16/1/2021,Perak,2619,341,2549,2,21,23,0,13,13,162,48,1553
16/1/2021,Perlis,508,57,495,2,0,2,0,0,0,12,13,301
16/1/2021,Pulau Pinang,1292,224,1249,0,35,35,0,24,24,193,0,720
16/1/2021,Sabah,2942,1214,2808,14,100,114,20,75,95,685,74,1184
16/1/2021,Sarawak,2842,776,2771,27,20,47,34,11,45,230,137,1940
16/1/2021,Selangor,887,630,827,4,144,148,4,151,155,493,10,15
16/1/2021,Terengganu,1307,268,1284,6,28,34,4,15,19,113,30,750
16/1/2021,W.P. Kuala Lumpur,3154,595,3091,3,57,60,1,35,36,318,19,1128
16/1/2021,W.P. Labuan,122,25,112,0,0,0,0,0,0,6,4,74
17/1/2021,Johor,4793,748,4668,49,202,251,2,42,44,637,106,102
17/1/2021,Kedah,1924,273,1873,3,66,69,5,66,71,268,7,1371
17/1/2021,Kelantan,1573,402,1500,1,77,78,1,34,35,303,4,779
17/1/2021,Melaka,1091,243,1039,1,5,6,7,25,32,128,21,677
17/1/2021,Negeri Sembilan,1331,633,1309,0,104,104,0,47,47,434,6,565
17/1/2021,Pahang,2170,701,2113,0,43,43,3,39,42,193,9,990
17/1/2021,Perak,2619,341,2549,3,17,20,7,18,25,156,37,1527
17/1/2021,Perlis,508,57,495,11,3,14,3,5,8,8,22,305
17/1/2021,Pulau Pinang,1292,224,1249,0,24,24,0,33,33,166,0,697
17/1/2021,Sabah,2942,1214,2808,19,102,121,14,77,91,682,77,1149
17/1/2021,Sarawak,2842,850,2771,33,78,111,27,28,55,235,154,1199
17/1/2021,Selangor,887,630,827,7,156,163,4,150,154,500,12,14
17/1/2021,Terengganu,1307,268,1284,10,34,44,7,22,29,124,36,743
17/1/2021,W.P. Kuala Lumpur,3154,595,3091,5,69,74,4,52,56,334,27,1100
17/1/2021,W.P. Labuan,122,25,112,0,0,0,0,0,0,6,4,63
18/1/2021,Johor,4793,748,4683,8,135,143,15,45,60,633,89,103
18/1/2021,Kedah,1924,273,1863,14,47,61,1,53,54,273,17,1296
18/1/2021,Kelantan,1529,358,1456,2,30,32,3,76,79,257,3,785
18/1/2021,Melaka,1091,243,1039,0,14,14,6,36,42,108,15,690
18/1/2021,Negeri Sembilan,1331,633,1309,1,94,95,2,63,65,469,5,590
18/1/2021,Pahang,2170,701,2113,5,19,24,3,43,46,169,11,971
18/1/2021,Perak,2619,341,2549,0,31,31,9,25,34,171,17,1569
18/1/2021,Perlis,508,57,495,3,2,5,1,2,3,9,21,319
18/1/2021,Pulau Pinang,1292,224,1249,0,29,29,0,29,29,159,0,759
18/1/2021,Sabah,2942,1214,2808,19,113,132,14,55,69,703,76,1124
18/1/2021,Sarawak,3054,866,2985,35,34,69,43,8,51,221,154,1300
18/1/2021,Selangor,1922,686,1822,16,121,137,3,155,158,484,39,613
18/1/2021,Terengganu,1307,268,1284,4,7,11,2,17,19,114,38,737
18/1/2021,W.P. Kuala Lumpur,3154,595,3087,4,31,35,3,37,40,347,17,1152
18/1/2021,W.P. Labuan,122,25,112,0,1,1,0,0,0,7,3,72
19/1/2021,Johor,4550,673,4440,30,173,203,28,88,116,645,83,99
19/1/2021,Kedah,1924,273,1863,13,37,50,1,56,57,268,17,1305
19/1/2021,Kelantan,1529,358,1456,3,75,78,1,57,58,276,5,772
19/1/2021,Melaka,1091,243,1039,0,18,18,6,26,32,93,14,702
19/1/2021,Negeri Sembilan,1331,633,1309,2,74,76,2,63,65,469,5,604
19/1/2021,Pahang,2170,701,2113,0,26,26,4,24,28,171,7,1083
19/1/2021,Perak,2619,341,2549,4,18,22,4,28,32,147,23,1596
19/1/2021,Perlis,508,57,495,4,0,4,8,0,8,7,18,320
19/1/2021,Pulau Pinang,1292,224,1249,0,23,23,0,30,30,155,0,808
19/1/2021,Sabah,2948,1244,2814,23,119,142,16,82,98,689,75,1115
19/1/2021,Sarawak,3054,866,2985,32,188,220,27,20,47,303,156,1350
19/1/2021,Selangor,2756,794,2604,49,155,204,7,135,142,538,83,958
19/1/2021,Terengganu,1307,268,1284,11,14,25,11,8,19,120,38,16
19/1/2021,W.P. Kuala Lumpur,3154,595,3087,6,28,34,1,51,52,330,27,1201
19/1/2021,W.P. Labuan,122,25,112,0,3,3,0,1,1,9,1,72
20/1/2021,Johor,4550,673,4440,25,143,168,9,51,60,595,112,99
20/1/2021,Kedah,1924,273,1863,6,22,28,1,41,42,240,14,1377
20/1/2021,Kelantan,1529,358,1456,4,41,45,3,55,58,263,5,768
20/1/2021,Melaka,1091,243,1039,12,29,41,5,11,16,107,22,725
20/1/2021,Negeri Sembilan,1331,633,1309,3,66,69,3,64,67,452,5,635
20/1/2021,Pahang,2170,701,2113,3,22,25,0,26,26,167,10,1094
20/1/2021,Perak,2619,341,2549,3,35,38,0,20,20,166,18,1645
20/1/2021,Perlis,508,57,493,5,2,7,7,0,7,7,12,310
20/1/2021,Pulau Pinang,1292,224,1249,0,19,19,0,27,27,129,0,810
20/1/2021,Sabah,2948,1244,2817,31,106,137,14,86,100,724,86,1171
20/1/2021,Sarawak,3054,866,2985,35,24,59,31,8,39,265,129,1184
20/1/2021,Selangor,4727,1081,4521,83,174,257,56,127,183,602,309,1968
20/1/2021,Terengganu,1307,268,1284,8,15,23,18,11,29,126,31,825
20/1/2021,W.P. Kuala Lumpur,3154,595,3087,5,54,59,1,53,54,344,25,1219
20/1/2021,W.P. Labuan,122,25,112,1,0,1,0,0,0,8,2,67
21/1/2021,Johor,4550,691,4440,9,102,111,13,61,74,606,105,93
21/1/2021,Kedah,1924,273,1863,5,32,37,0,35,35,237,10,1239
21/1/2021,Kelantan,1529,358,1456,0,52,52,2,47,49,272,2,768
21/1/2021,Melaka,1101,248,1049,2,25,27,0,17,17,115,20,757
21/1/2021,Negeri Sembilan,1331,633,1309,5,72,77,4,55,59,454,2,645
21/1/2021,Pahang,2170,701,2113,3,29,32,4,41,45,153,9,1094
21/1/2021,Perak,2619,359,2549,1,45,46,2,24,26,181,16,1625
21/1/2021,Perlis,508,57,493,14,2,16,7,1,8,8,11,305
21/1/2021,Pulau Pinang,1292,224,1249,0,23,23,0,37,37,146,1,746
21/1/2021,Sabah,2948,1329,2817,29,138,167,18,58,76,757,93,1227
21/1/2021,Sarawak,3054,866,2985,48,114,162,59,96,155,264,154,1403
21/1/2021,Selangor,5136,1248,4914,273,169,442,44,170,214,612,406,2194
21/1/2021,Terengganu,1307,268,1284,6,34,40,4,25,29,136,30,766
21/1/2021,W.P. Kuala Lumpur,3154,615,3087,5,47,52,0,68,68,349,31,1181
21/1/2021,W.P. Labuan,122,25,112,3,2,5,0,0,0,10,5,58
22/1/2021,Johor,4550,691,4440,18,120,138,20,43,63,651,84,83
22/1/2021,Kedah,1924,273,1863,8,50,58,0,44,44,245,12,1109
22/1/2021,Kelantan,1529,358,1456,4,45,49,3,48,51,261,5,744
22/1/2021,Melaka,1101,248,1049,6,44,50,2,8,10,151,24,685
22/1/2021,Negeri Sembilan,1331,633,1284,2,81,83,2,54,56,464,2,606
22/1/2021,Pahang,2170,701,2113,2,36,38,3,41,44,147,8,1036
22/1/2021,Perak,2728,359,2658,4,42,46,2,19,21,182,20,1565
22/1/2021,Perlis,508,57,493,5,1,6,2,1,3,8,12,304
22/1/2021,Pulau Pinang,1292,224,1249,3,31,34,0,27,27,164,4,750
22/1/2021,Sabah,2948,1301,2817,19,107,126,21,65,86,781,90,1233
22/1/2021,Sarawak,3054,866,2985,33,134,167,48,140,188,260,138,1320
22/1/2021,Selangor,5136,1272,4914,158,149,307,144,179,323,620,416,2261
22/1/2021,Terengganu,1307,268,1284,4,22,26,12,17,29,141,22,753
22/1/2021,W.P. Kuala Lumpur,3154,619,3087,3,55,58,3,38,41,402,20,1138
22/1/2021,W.P. Labuan,122,25,112,0,1,1,0,0,0,11,2,66
23/1/2021,Johor,4550,706,4440,23,141,164,2,47,49,669,101,89
23/1/2021,Kedah,1924,273,1863,10,67,77,4,33,37,327,10,1079
23/1/2021,Kelantan,1619,382,1546,3,65,68,3,60,63,266,4,773
23/1/2021,Melaka,1101,248,1049,15,45,60,10,44,54,146,31,624
23/1/2021,Negeri Sembilan,1331,633,1284,0,72,72,0,61,61,459,2,540
23/1/2021,Pahang,2170,701,2113,4,42,46,5,32,37,157,7,979
23/1/2021,Perak,2728,359,2658,10,35,45,2,16,18,192,22,1471
23/1/2021,Perlis,508,57,493,7,3,10,3,0,3,14,15,308
23/1/2021,Pulau Pinang,1292,224,1249,3,21,24,3,18,21,163,4,695
23/1/2021,Sabah,2948,1301,2817,11,123,134,12,119,131,847,64,782
23/1/2021,Sarawak,3054,866,2985,40,123,163,30,134,164,259,148,1432
23/1/2021,Selangor,5136,1272,4914,138,161,299,118,195,313,624,400,2313
23/1/2021,Terengganu,1307,268,1284,13,43,56,9,20,29,166,25,11
23/1/2021,W.P. Kuala Lumpur,3154,624,3087,2,53,55,1,47,48,400,20,1072
23/1/2021,W.P. Labuan,122,25,112,0,0,0,0,3,3,8,2,69
24/1/2021,Johor,4550,706,4440,25,142,167,4,48,52,690,100,83
24/1/2021,Kedah,1924,273,1863,4,45,49,0,25,25,302,5,1196
24/1/2021,Kelantan,1619,382,1546,1,31,32,3,49,52,247,2,830
24/1/2021,Melaka,1101,231,1048,3,16,19,5,37,42,108,32,645
24/1/2021,Negeri Sembilan,1331,633,1284,10,77,87,1,54,55,470,11,349
24/1/2021,Pahang,2170,701,2113,2,30,32,5,31,36,155,4,950
24/1/2021,Perak,2728,359,2658,2,26,28,8,22,30,184,21,1413
24/1/2021,Perlis,508,57,493,1,0,1,0,0,0,13,17,307
24/1/2021,Pulau Pinang,1292,224,1249,0,38,38,1,22,23,176,3,652
24/1/2021,Sabah,2948,1301,2817,20,95,115,25,68,93,760,84,1068
24/1/2021,Sarawak,3054,866,2985,27,63,90,27,108,135,317,140,1401
24/1/2021,Selangor,5136,1272,4914,131,172,303,100,143,243,665,428,2185
24/1/2021,Terengganu,1307,268,1284,9,28,37,7,15,22,178,31,721
24/1/2021,W.P. Kuala Lumpur,3154,654,3087,5,39,44,2,44,46,376,33,1075
24/1/2021,W.P. Labuan,122,25,112,1,1,2,0,2,2,7,3,68
25/1/2021,Johor,4550,706,4440,10,113,123,4,46,50,714,94,103
25/1/2021,Kedah,1924,273,1863,4,52,56,1,78,79,279,8,1230
25/1/2021,Kelantan,2371,394,2223,2,46,48,1,48,49,246,4,1381
25/1/2021,Melaka,1101,231,1048,0,21,21,1,27,28,102,31,641
25/1/2021,Negeri Sembilan,1331,633,1284,3,56,59,4,69,73,432,10,523
25/1/2021,Pahang,2170,701,2113,4,34,38,2,26,28,162,6,924
25/1/2021,Perak,2728,359,2658,3,13,16,4,22,26,177,12,1492
25/1/2021,Perlis,508,57,493,3,1,4,7,0,7,10,11,320
25/1/2021,Pulau Pinang,1292,224,1249,0,25,25,0,20,20,181,0,678
25/1/2021,Sabah,2948,1307,2817,21,95,116,10,107,117,741,89,1194
25/1/2021,Sarawak,3054,866,2985,28,166,194,38,130,168,303,128,1379
25/1/2021,Selangor,5136,1272,4914,104,166,270,67,141,208,687,429,2276
25/1/2021,Terengganu,1307,288,1284,4,29,33,5,37,42,170,25,723
25/1/2021,W.P. Kuala Lumpur,3154,654,3087,7,55,62,4,54,58,398,38,1092
25/1/2021,W.P. Labuan,122,25,112,0,1,1,0,0,0,8,3,66
26/1/2021,Johor,4550,706,4440,20,178,198,7,56,63,761,85,100
26/1/2021,Kedah,1924,413,1863,8,33,41,1,44,45,274,11,1230
26/1/2021,Kelantan,2388,418,2254,9,59,68,4,53,57,260,9,1403
26/1/2021,Melaka,1101,231,1048,13,8,21,8,19,27,91,36,656
26/1/2021,Negeri Sembilan,1331,633,1284,0,41,41,3,66,69,393,7,558
26/1/2021,Pahang,2170,701,2113,6,12,18,2,23,25,150,10,1017
26/1/2021,Perak,2728,359,2656,0,10,10,1,23,24,145,11,1548
26/1/2021,Perlis,508,57,493,1,1,2,3,1,4,8,10,323
26/1/2021,Pulau Pinang,1292,224,1249,0,24,24,0,25,25,168,0,713
26/1/2021,Sabah,2948,1307,2817,23,82,105,14,88,102,723,96,1118
26/1/2021,Sarawak,3054,866,2985,48,129,177,25,146,171,306,137,1358
26/1/2021,Selangor,5136,1268,4914,126,136,262,106,163,269,666,422,2360
26/1/2021,Terengganu,1307,288,1284,5,11,16,2,24,26,159,29,764
26/1/2021,W.P. Kuala Lumpur,3154,743,3087,3,36,39,7,28,35,403,34,1136
26/1/2021,W.P. Labuan,122,25,112,1,0,1,0,2,2,6,4,66
27/1/2021,Johor,4550,706,4440,6,158,164,4,48,52,775,51,105
27/1/2021,Kedah,1924,413,1863,5,27,32,0,46,46,266,14,1235
27/1/2021,Kelantan,2388,416,2259,1,59,60,1,37,38,277,9,1664
27/1/2021,Melaka,1101,231,1048,9,15,24,13,24,37,82,32,685
27/1/2021,Negeri Sembilan,1331,633,1284,0,37,37,4,58,62,369,3,580
27/1/2021,Pahang,2170,701,2113,3,22,25,3,26,29,146,6,1064
27/1/2021,Perak,2728,359,2656,4,48,52,2,14,16,173,19,1590
27/1/2021,Perlis,508,57,493,2,0,2,3,0,3,6,7,331
27/1/2021,Pulau Pinang,1292,224,1249,0,22,22,0,17,17,165,0,738
27/1/2021,Sabah,2948,1307,2811,26,95,121,30,83,113,677,89,1228
27/1/2021,Sarawak,3054,866,2985,61,190,251,37,145,182,330,169,1402
27/1/2021,Selangor,5136,1268,4910,143,163,306,146,181,327,673,423,2394
27/1/2021,Terengganu,1307,288,1284,4,11,15,10,30,40,140,22,712
27/1/2021,W.P. Kuala Lumpur,3154,743,3087,4,42,46,5,46,51,422,46,1072
27/1/2021,W.P. Labuan,122,25,112,0,0,0,0,0,0,6,4,70
28/1/2021,Johor,4550,706,4434,10,142,152,5,59,64,761,62,110
28/1/2021,Kedah,1924,413,1863,4,36,40,1,49,50,266,8,1195
28/1/2021,Kelantan,2388,416,2259,13,32,45,14,54,68,261,8,1320
28/1/2021,Melaka,1101,231,1048,15,17,32,7,9,16,90,40,694
28/1/2021,Negeri Sembilan,1331,633,1284,0,42,42,0,64,64,334,3,527
28/1/2021,Pahang,2170,701,2113,5,29,34,2,24,26,151,7,1054
28/1/2021,Perak,2728,359,2656,2,31,33,3,18,21,187,15,1616
28/1/2021,Perlis,508,57,493,1,0,1,1,0,1,6,8,324
28/1/2021,Pulau Pinang,1292,224,1249,0,18,18,0,40,40,140,0,680
28/1/2021,Sabah,2948,1280,2811,18,81,99,22,64,86,708,80,1269
28/1/2021,Sarawak,3054,866,2983,49,110,159,38,91,129,306,165,1392
28/1/2021,Selangor,5136,1268,4910,111,137,248,128,158,286,663,432,2355
28/1/2021,Terengganu,1307,288,1284,10,9,19,5,15,20,134,26,638
28/1/2021,W.P. Kuala Lumpur,3154,743,3087,9,35,44,4,71,75,394,49,979
28/1/2021,W.P. Labuan,122,25,112,1,3,4,0,0,0,9,2,73
29/1/2021,Johor,4550,706,4434,9,135,144,1,58,59,730,65,101
29/1/2021,Kedah,1924,413,1863,6,50,56,0,48,48,291,13,1177
29/1/2021,Kelantan,2388,404,2259,0,28,28,8,50,58,238,0,1228
29/1/2021,Melaka,1101,231,1048,6,9,15,6,5,11,94,40,716
29/1/2021,Negeri Sembilan,1331,633,1284,4,42,46,1,40,41,328,4,518
29/1/2021,Pahang,2170,701,2113,1,30,31,3,26,29,154,6,1036
29/1/2021,Perak,2728,359,2656,8,26,34,0,32,32,174,26,1616
29/1/2021,Perlis,508,57,493,1,3,4,1,1,2,8,6,307
29/1/2021,Pulau Pinang,1292,224,1249,0,18,18,0,13,13,147,0,684
29/1/2021,Sabah,2948,1280,2811,27,71,98,21,81,102,665,84,1222
29/1/2021,Sarawak,3054,866,2983,39,165,204,39,150,189,344,207,1348
29/1/2021,Selangor,5136,1268,4910,175,139,314,93,162,255,667,441,2378
29/1/2021,Terengganu,1307,288,1284,11,30,41,12,30,42,134,25,649
29/1/2021,W.P. Kuala Lumpur,3154,756,3087,5,32,37,3,69,72,347,54,1047
29/1/2021,W.P. Labuan,122,25,112,0,3,3,0,1,1,12,2,66
30/1/2021,Johor,4550,706,4434,8,146,154,1,46,47,779,66,110
30/1/2021,Kedah,1924,413,1863,4,27,31,3,30,33,275,9,1147
30/1/2021,Kelantan,2388,404,2259,2,31,33,0,36,36,231,2,1196
30/1/2021,Melaka,1101,231,1048,6,19,25,3,24,27,89,43,662
30/1/2021,Negeri Sembilan,1331,633,1284,0,35,35,0,48,48,308,2,498
30/1/2021,Pahang,2170,701,2113,1,30,31,4,28,32,152,2,976
30/1/2021,Perak,2728,359,2656,3,24,27,6,28,34,167,20,1536
30/1/2021,Perlis,508,57,493,5,0,5,2,1,3,6,13,274
30/1/2021,Pulau Pinang,1292,224,1249,0,16,16,0,29,29,138,0,684
30/1/2021,Sabah,2948,1280,2811,20,60,80,15,70,85,641,87,1202
30/1/2021,Sarawak,3054,866,2983,57,206,263,51,135,186,345,178,1362
30/1/2021,Selangor,5161,1268,4935,165,149,314,141,172,313,677,480,2205
30/1/2021,Terengganu,1307,288,1284,12,35,47,7,32,39,136,31,641
30/1/2021,W.P. Kuala Lumpur,3113,726,3046,6,44,50,3,56,59,334,70,940
30/1/2021,W.P. Labuan,122,25,112,0,0,0,0,1,1,11,2,59
31/1/2021,Johor,4550,706,4434,10,138,148,2,50,52,782,66,109
31/1/2021,Kedah,1924,413,1863,0,41,41,1,33,34,279,3,1233
31/1/2021,Kelantan,2390,406,2261,0,28,28,2,20,22,241,0,1281
31/1/2021,Melaka,1101,231,1048,1,22,23,2,11,13,100,42,639
31/1/2021,Negeri Sembilan,1331,633,1284,1,29,30,0,37,37,295,3,483
31/1/2021,Pahang,2170,701,2113,1,24,25,2,22,24,153,1,975
31/1/2021,Perak,2728,359,2656,2,15,17,4,18,22,160,16,1473
31/1/2021,Perlis,508,57,493,3,0,3,2,0,2,7,12,274
31/1/2021,Pulau Pinang,1292,224,1249,0,6,6,0,24,24,120,0,672
31/1/2021,Sabah,2948,1280,2801,31,59,90,20,80,100,614,99,1144
31/1/2021,Sarawak,3054,866,2979,47,59,106,33,168,201,324,190,1366
31/1/2021,Selangor,5161,1268,4935,99,148,247,90,168,258,653,499,2170
31/1/2021,Terengganu,1307,288,1295,9,18,27,5,22,27,130,36,582
31/1/2021,W.P. Kuala Lumpur,3113,776,3046,7,28,35,5,62,67,296,58,951
31/1/2021,W.P. Labuan,122,25,112,1,0,1,0,1,1,12,3,62
1/2/2021,Johor,4550,706,4434,1,114,115,2,64,66,736,61,112
1/2/2021,Kedah,1924,413,1863,9,30,39,0,65,65,244,12,1248
1/2/2021,Kelantan,2390,406,2261,2,35,37,0,32,32,242,1,1306
1/2/2021,Melaka,1101,231,1048,3,38,41,13,32,45,106,32,685
1/2/2021,Negeri Sembilan,1331,633,1284,0,57,57,1,25,26,321,2,509
1/2/2021,Pahang,2170,701,2113,1,21,22,0,36,36,148,2,982
1/2/2021,Perak,2728,359,2656,2,18,20,6,15,21,158,13,1562
1/2/2021,Perlis,508,57,493,1,0,1,6,0,6,7,6,269
1/2/2021,Pulau Pinang,1292,224,1249,0,24,24,0,24,24,119,0,687
1/2/2021,Sabah,2948,1282,2801,10,43,53,25,70,95,590,68,1161
1/2/2021,Sarawak,3054,866,2979,44,196,240,33,136,169,333,199,1432
1/2/2021,Selangor,5161,1268,4935,137,118,255,181,133,314,635,432,2296
1/2/2021,Terengganu,1307,288,1295,5,12,17,3,18,21,124,38,555
1/2/2021,W.P. Kuala Lumpur,3113,780,3046,6,42,48,3,42,45,296,60,947
1/2/2021,W.P. Labuan,122,25,112,0,0,0,0,1,1,11,3,60
2/2/2021,Johor,4550,706,4434,0,166,166,0,58,58,755,62,41
2/2/2021,Kedah,1924,413,1863,3,15,18,0,32,32,242,7,1247
2/2/2021,Kelantan,2596,406,2467,2,17,19,1,26,27,231,2,1335
2/2/2021,Melaka,1101,231,1048,3,38,41,13,32,45,92,24,725
2/2/2021,Negeri Sembilan,1331,633,1284,1,41,42,0,44,44,317,1,574
2/2/2021,Pahang,2170,701,2113,3,12,15,1,32,33,128,4,1062
2/2/2021,Perak,2728,359,2656,1,14,15,0,34,34,134,9,1646
2/2/2021,Perlis,508,57,493,3,0,3,2,0,2,7,7,236
2/2/2021,Pulau Pinang,1292,224,1249,1,21,22,0,30,30,103,1,700
2/2/2021,Sabah,2948,1282,2801,15,55,70,13,81,94,554,79,1222
2/2/2021,Sarawak,3054,866,2979,48,85,133,37,167,204,321,200,1319
2/2/2021,Selangor,5161,1268,4935,112,147,259,195,156,351,641,338,2447
2/2/2021,Terengganu,1307,288,1295,4,11,15,7,15,22,119,35,594
2/2/2021,W.P. Kuala Lumpur,3113,780,3046,5,31,36,3,39,42,305,59,1041
2/2/2021,W.P. Labuan,122,25,112,0,0,0,0,1,1,12,2,58
3/2/2021,Johor,4550,706,4434,0,136,136,0,61,61,761,60,37
3/2/2021,Kedah,1924,413,1863,1,29,30,2,36,38,237,5,1251
3/2/2021,Kelantan,2596,406,2467,1,26,27,1,52,53,202,2,1351
3/2/2021,Melaka,1101,231,1048,12,13,25,4,8,12,97,32,705
3/2/2021,Negeri Sembilan,1331,633,1284,5,26,31,3,40,43,298,5,613
3/2/2021,Pahang,2170,701,2113,1,13,14,2,12,14,129,3,1059
3/2/2021,Perak,2728,359,2656,1,13,14,5,22,27,121,9,1653
3/2/2021,Perlis,508,57,493,4,0,4,2,0,2,8,9,233
3/2/2021,Pulau Pinang,1292,224,1249,0,13,13,0,21,21,92,0,746
3/2/2021,Sabah,2948,1282,2801,17,105,122,27,51,78,565,70,1258
3/2/2021,Sarawak,3054,866,2978,46,110,156,46,93,139,311,198,1402
3/2/2021,Selangor,5161,1304,4935,149,151,300,108,182,290,599,487,2352
3/2/2021,Terengganu,1307,288,1295,14,15,29,3,24,27,110,43,572
3/2/2021,W.P. Kuala Lumpur,3113,780,3046,3,41,44,1,39,40,309,76,1064
3/2/2021,W.P. Labuan,122,25,112,2,0,2,0,1,1,12,4,60
4/2/2021,Johor,4550,706,4434,0,172,172,0,67,67,724,182,37
4/2/2021,Kedah,1924,413,1863,4,32,36,0,15,15,252,8,1210
4/2/2021,Kelantan,2596,406,2467,2,23,25,0,47,47,180,3,1353
4/2/2021,Melaka,1101,231,1048,6,13,19,4,12,16,98,30,783
4/2/2021,Negeri Sembilan,1331,633,1284,5,65,70,1,45,46,311,9,566
4/2/2021,Pahang,2170,701,2113,3,12,15,2,28,30,113,4,1063
4/2/2021,Perak,2728,359,2656,1,22,23,0,15,15,130,8,1686
4/2/2021,Perlis,508,57,493,2,0,2,3,0,3,8,8,250
4/2/2021,Pulau Pinang,1292,224,1249,0,19,19,0,12,12,99,0,736
4/2/2021,Sabah,2948,1282,2801,17,83,100,18,56,74,645,69,1162
4/2/2021,Sarawak,3054,866,2978,39,142,181,52,127,179,327,165,1579
4/2/2021,Selangor,5161,1304,4935,116,147,263,191,175,366,608,340,2446
4/2/2021,Terengganu,1307,288,1295,2,15,17,8,17,25,108,39,546
4/2/2021,W.P. Kuala Lumpur,3113,780,3046,3,25,28,4,38,42,288,61,1125
4/2/2021,W.P. Labuan,122,25,112,0,0,0,1,4,5,9,3,54
5/2/2021,Johor,4550,706,4434,0,156,156,0,94,94,708,184,38
5/2/2021,Kedah,1924,426,1863,4,24,28,0,42,42,239,5,1000
5/2/2021,Kelantan,2596,406,2467,0,33,33,4,34,38,178,0,1229
5/2/2021,Melaka,1101,231,1048,6,27,33,1,29,30,93,29,769
5/2/2021,Negeri Sembilan,1331,633,1284,3,37,40,2,60,62,284,10,538
5/2/2021,Pahang,2170,701,2113,0,7,7,0,20,20,108,4,1065
5/2/2021,Perak,2728,359,2656,2,20,22,1,17,18,130,7,1624
5/2/2021,Perlis,508,57,493,3,1,4,0,0,0,9,8,258
5/2/2021,Pulau Pinang,1292,224,1249,0,24,24,0,15,15,107,0,718
5/2/2021,Sabah,2948,1282,2801,19,75,94,12,68,80,635,74,1148
5/2/2021,Sarawak,3054,866,2978,40,209,249,36,164,200,350,163,1404
5/2/2021,Selangor,5161,1304,4935,165,140,305,142,142,284,585,449,2423
5/2/2021,Terengganu,1307,288,1295,10,27,37,13,29,42,106,32,553
5/2/2021,W.P. Kuala Lumpur,3113,780,3046,3,27,30,5,27,32,290,56,1194
5/2/2021,W.P. Labuan,122,25,112,1,0,1,0,0,0,9,4,54
6/2/2021,Johor,4550,706,4434,0,171,171,0,76,76,688,168,39
6/2/2021,Kedah,1924,426,1863,6,26,32,1,36,37,232,7,1253
6/2/2021,Kelantan,2596,406,2467,0,31,31,0,23,23,184,0,1193
6/2/2021,Melaka,1101,231,1048,7,25,32,8,23,31,95,27,677
6/2/2021,Negeri Sembilan,1331,633,1284,0,24,24,2,53,55,253,8,476
6/2/2021,Pahang,2170,701,2113,2,15,17,0,18,18,105,5,991
6/2/2021,Perak,2728,359,2656,3,9,12,2,16,18,119,9,1527
6/2/2021,Perlis,508,57,493,4,1,5,2,2,4,8,6,257
6/2/2021,Pulau Pinang,1292,224,1249,0,29,29,0,9,9,127,0,668
6/2/2021,Sabah,2948,1282,2801,15,69,84,16,61,77,630,64,1101
6/2/2021,Sarawak,3054,866,2978,46,134,180,29,167,196,311,153,1464
6/2/2021,Selangor,5161,1304,4935,181,127,308,121,151,272,561,489,2322
6/2/2021,Terengganu,1307,288,1295,12,19,31,6,17,23,108,37,543
6/2/2021,W.P. Kuala Lumpur,3113,780,3046,0,26,26,4,39,43,273,49,1075
6/2/2021,W.P. Labuan,122,25,112,2,2,4,0,3,3,9,4,60
7/2/2021,Johor,4550,706,4434,0,168,168,0,112,112,638,158,39
7/2/2021,Kedah,1924,426,1863,3,11,14,0,32,32,223,4,1281
7/2/2021,Kelantan,2596,406,2467,1,31,32,0,29,29,186,1,1304
7/2/2021,Melaka,1101,231,1048,1,16,17,10,29,39,80,18,661
7/2/2021,Negeri Sembilan,1331,633,1284,1,23,24,1,39,40,270,5,498
7/2/2021,Pahang,2170,701,2113,1,15,16,3,29,32,90,3,997
7/2/2021,Perak,2728,359,2656,2,7,9,3,20,23,104,6,1550
7/2/2021,Perlis,508,57,493,5,2,7,2,0,2,10,10,257
7/2/2021,Pulau Pinang,1292,224,1249,0,23,23,0,16,16,129,0,664
7/2/2021,Sabah,2948,1270,2801,19,72,91,22,69,91,593,59,1098
7/2/2021,Sarawak,3054,866,2978,28,165,193,23,121,144,334,167,1363
7/2/2021,Selangor,5161,1304,4935,179,132,311,112,133,245,562,481,2282
7/2/2021,Terengganu,1307,288,1295,9,18,27,9,8,17,118,37,605
7/2/2021,W.P. Kuala Lumpur,3113,780,3046,2,34,36,0,25,25,283,50,1058
7/2/2021,W.P. Labuan,122,25,112,2,1,3,0,1,1,10,6,65
8/2/2021,Johor,4550,973,4434,0,193,193,0,100,100,637,189,39
8/2/2021,Kedah,1924,426,1863,3,20,23,1,24,25,200,6,1272
8/2/2021,Kelantan,2596,383,2467,1,38,39,0,27,27,197,2,1370
8/2/2021,Melaka,1101,231,1048,1,20,21,1,11,12,89,18,658
8/2/2021,Negeri Sembilan,1331,633,1284,7,16,23,0,33,33,217,8,521
8/2/2021,Pahang,2170,701,2113,1,3,4,2,8,10,87,2,1036
8/2/2021,Perak,2728,359,2656,2,12,14,1,26,27,90,8,1591
8/2/2021,Perlis,508,57,493,4,4,8,1,0,1,13,8,266
8/2/2021,Pulau Pinang,1292,224,1249,0,23,23,0,16,16,138,0,705
8/2/2021,Sabah,2948,1270,2801,25,54,79,10,40,50,499,76,951
8/2/2021,Sarawak,3054,866,2978,37,144,181,30,119,149,351,173,1376
8/2/2021,Selangor,5161,1304,4935,150,135,285,117,118,235,575,440,2382
8/2/2021,Terengganu,1307,288,1295,6,17,23,7,19,26,116,36,618
8/2/2021,W.P. Kuala Lumpur,3113,780,3046,6,34,40,1,41,42,280,51,1092
8/2/2021,W.P. Labuan,122,25,112,2,0,2,0,1,1,10,8,65
9/2/2021,Johor,4550,973,4434,87,85,172,46,51,97,610,216,38
9/2/2021,Kedah,1924,426,1863,2,14,16,0,22,22,206,4,1260
9/2/2021,Kelantan,2596,383,2467,2,21,23,1,25,26,194,3,1416
9/2/2021,Melaka,1101,231,1048,0,9,9,3,12,15,86,15,703
9/2/2021,Negeri Sembilan,1331,633,1284,0,15,15,0,25,25,191,8,577
9/2/2021,Pahang,2170,701,2113,2,15,17,0,12,12,86,4,1066
9/2/2021,Perak,2728,359,2656,2,27,29,0,13,13,107,8,1671
9/2/2021,Perlis,508,57,493,0,0,0,4,2,6,11,6,298
9/2/2021,Pulau Pinang,1292,224,1249,0,21,21,0,16,16,137,0,764
9/2/2021,Sabah,2948,1272,2801,21,71,92,4,44,48,495,79,1219
9/2/2021,Sarawak,3054,866,2970,34,64,98,29,107,136,319,167,1308
9/2/2021,Selangor,5161,1304,4935,187,123,310,135,148,283,556,421,2451
9/2/2021,Terengganu,1307,288,1295,8,24,32,11,10,21,130,33,632
9/2/2021,W.P. Kuala Lumpur,3113,780,3046,2,25,27,1,45,46,253,46,1133
9/2/2021,W.P. Labuan,122,25,112,2,0,2,0,1,1,9,6,79
10/2/2021,Johor,4550,973,4434,82,118,200,75,68,143,619,191,44
10/2/2021,Kedah,1924,426,1863,5,17,22,0,39,39,188,9,1280
10/2/2021,Kelantan,2686,398,2557,1,37,38,3,39,42,194,1,1470
10/2/2021,Melaka,1101,231,1048,8,9,17,6,18,24,77,17,690
10/2/2021,Negeri Sembilan,1331,633,1284,8,22,30,3,23,26,185,10,606
10/2/2021,Pahang,2170,701,2113,0,6,6,1,12,13,80,3,1115
10/2/2021,Perak,2728,359,2656,0,22,22,1,15,16,109,9,1690
10/2/2021,Perlis,508,57,493,2,1,3,0,1,1,5,6,297
10/2/2021,Pulau Pinang,1292,224,1249,0,23,23,0,13,13,147,0,789
10/2/2021,Sabah,2948,1272,2801,19,65,84,18,48,66,453,78,1219
10/2/2021,Sarawak,3054,866,2970,46,88,134,18,97,115,312,189,1411
10/2/2021,Selangor,5161,1304,4935,221,136,357,90,147,237,551,474,2486
10/2/2021,Terengganu,1307,288,1295,3,9,12,3,11,14,128,33,566
10/2/2021,W.P. Kuala Lumpur,3113,762,3046,0,34,34,9,29,38,256,38,1162
10/2/2021,W.P. Labuan,122,25,112,0,1,1,0,1,1,9,5,83
11/2/2021,Johor,4550,973,4434,74,63,137,66,59,125,571,157,38
11/2/2021,Kedah,1924,426,1863,1,15,16,0,28,28,182,5,1262
11/2/2021,Kelantan,2686,398,2557,3,27,30,0,25,25,195,4,1444
11/2/2021,Melaka,1101,231,1048,1,6,7,3,12,15,71,15,694
11/2/2021,Negeri Sembilan,1331,633,1284,1,23,24,1,21,22,184,10,575
11/2/2021,Pahang,2170,701,2113,0,13,13,3,18,21,80,0,1149
11/2/2021,Perak,2728,359,2656,3,16,19,2,12,14,112,12,1649
11/2/2021,Perlis,508,57,493,1,1,2,3,0,3,6,3,287
11/2/2021,Pulau Pinang,1292,224,1249,0,19,19,0,19,19,143,0,742
11/2/2021,Sabah,2948,1272,2801,21,53,74,15,53,68,432,83,1231
11/2/2021,Sarawak,3054,866,2970,43,110,153,29,120,149,307,208,1419
11/2/2021,Selangor,5161,1304,4935,181,115,296,113,152,265,523,473,2340
11/2/2021,Terengganu,1307,288,1295,4,8,12,11,18,29,118,26,554
11/2/2021,W.P. Kuala Lumpur,3113,732,3046,0,35,35,1,27,28,270,44,1133
11/2/2021,W.P. Labuan,122,25,112,0,0,0,0,0,0,8,6,77
12/2/2021,Johor,4550,973,4434,79,75,154,43,69,112,527,166,36
12/2/2021,Kedah,1924,426,1863,18,21,39,1,22,23,183,21,1183
12/2/2021,Kelantan,2686,398,2557,0,35,35,3,36,39,199,1,1269
12/2/2021,Melaka,1101,231,1048,2,15,17,4,13,17,73,13,678
12/2/2021,Negeri Sembilan,1331,633,1284,2,18,20,1,27,28,178,10,551
12/2/2021,Pahang,2170,701,2113,1,16,17,1,7,8,83,1,1041
12/2/2021,Perak,2728,359,2656,3,20,23,4,14,18,118,13,1504
12/2/2021,Perlis,508,57,493,3,0,3,0,2,2,4,6,243
12/2/2021,Pulau Pinang,1292,224,1249,0,28,28,0,26,26,144,0,642
12/2/2021,Sabah,2948,1272,2801,10,43,53,23,52,75,399,69,1195
12/2/2021,Sarawak,3054,866,2970,53,139,192,57,143,200,336,213,1346
12/2/2021,Selangor,5161,1304,4935,160,103,263,90,128,218,512,454,2146
12/2/2021,Terengganu,1307,288,1295,3,10,13,4,12,16,114,25,634
12/2/2021,W.P. Kuala Lumpur,3113,732,3046,4,35,39,2,41,43,257,52,1022
12/2/2021,W.P. Labuan,122,25,112,0,6,6,0,0,0,14,2,62
13/2/2021,Johor,4550,973,4434,71,58,129,70,65,135,506,141,40
13/2/2021,Kedah,1924,426,1863,1,25,26,1,23,24,204,2,1150
13/2/2021,Kelantan,2686,398,2557,1,28,29,1,20,21,207,1,1220
13/2/2021,Melaka,1101,231,1048,1,10,11,2,5,7,78,12,668
13/2/2021,Negeri Sembilan,1331,633,1284,0,17,17,3,20,23,174,7,533
13/2/2021,Pahang,2170,701,2113,0,6,6,0,12,12,76,1,964
13/2/2021,Perak,2728,359,2656,3,16,19,1,12,13,129,14,1504
13/2/2021,Perlis,508,57,493,0,0,0,1,0,1,4,6,244
13/2/2021,Pulau Pinang,1292,224,1249,0,14,14,0,20,20,142,0,630
13/2/2021,Sabah,2948,1272,2801,10,60,70,13,43,56,399,62,1097
13/2/2021,Sarawak,3054,866,2970,36,94,130,45,109,154,311,208,1345
13/2/2021,Selangor,5161,1304,4933,162,113,275,68,142,210,493,410,2194
13/2/2021,Terengganu,1307,288,1295,3,14,17,5,16,21,111,22,549
13/2/2021,W.P. Kuala Lumpur,3113,732,3046,3,11,14,6,27,33,244,49,1025
13/2/2021,W.P. Labuan,122,25,112,0,0,0,0,2,2,12,2,72
14/2/2021,Johor,4550,943,4434,87,63,150,64,42,106,506,156,43
14/2/2021,Kedah,1924,426,1863,0,32,32,1,26,27,212,8,1178
14/2/2021,Kelantan,2686,398,2557,2,12,14,1,30,31,183,1,1223
14/2/2021,Melaka,1101,231,1048,1,10,11,0,12,12,76,13,686
14/2/2021,Negeri Sembilan,1331,633,1284,1,11,12,7,22,29,162,1,544
14/2/2021,Pahang,2170,701,2113,1,4,5,1,7,8,70,1,926
14/2/2021,Perak,2728,359,2656,0,11,11,1,12,13,128,7,1454
14/2/2021,Perlis,508,57,493,1,0,1,1,0,1,4,6,239
14/2/2021,Pulau Pinang,1292,224,1249,0,12,12,0,23,23,129,0,618
14/2/2021,Sabah,2948,1272,2801,9,26,35,14,58,72,349,58,1090
14/2/2021,Sarawak,3054,866,2970,45,70,115,39,124,163,293,211,1296
14/2/2021,Selangor,5161,1304,4933,164,113,277,70,114,184,490,483,2172
14/2/2021,Terengganu,1307,288,1295,4,15,19,4,13,17,113,22,608
14/2/2021,W.P. Kuala Lumpur,3113,732,3046,2,46,48,2,28,30,261,56,1030
14/2/2021,W.P. Labuan,122,25,112,1,0,1,0,0,0,13,1,67
15/2/2021,Johor,4550,943,4432,61,68,129,46,45,91,490,156,43
15/2/2021,Kedah,1924,426,1863,3,54,57,0,32,32,235,4,1301
15/2/2021,Kelantan,2686,398,2557,0,25,25,2,34,36,178,0,1334
15/2/2021,Melaka,1101,231,1048,0,3,3,0,8,8,71,13,682
15/2/2021,Negeri Sembilan,1331,633,1284,1,21,22,1,21,22,158,1,553
15/2/2021,Pahang,2170,701,2113,0,15,15,0,13,13,75,1,1004
15/2/2021,Perak,2728,359,2656,0,14,14,0,10,10,132,6,1517
15/2/2021,Perlis,508,57,493,7,0,7,2,2,4,2,11,259
15/2/2021,Pulau Pinang,1292,224,1249,0,19,19,0,16,16,121,0,625
15/2/2021,Sabah,2948,1272,2801,14,38,52,20,45,65,326,52,1097
15/2/2021,Sarawak,3054,866,2970,40,188,228,15,192,207,289,236,1305
15/2/2021,Selangor,5161,1304,4933,140,88,228,79,91,170,483,429,2387
15/2/2021,Terengganu,1307,288,1290,1,9,10,4,14,18,108,19,620
15/2/2021,W.P. Kuala Lumpur,3113,732,3046,1,22,23,3,27,30,262,58,1187
15/2/2021,W.P. Labuan,122,25,112,0,0,0,0,0,0,13,1,67
16/2/2021,Johor,4550,943,4432,90,69,159,64,55,119,474,174,43
16/2/2021,Kedah,1924,426,1863,1,7,8,0,25,25,223,4,1368
16/2/2021,Kelantan,2686,398,2557,0,22,22,0,31,31,166,0,1419
16/2/2021,Melaka,1101,231,1048,5,9,14,2,12,14,67,16,782
16/2/2021,Negeri Sembilan,1331,633,1284,0,14,14,0,12,12,159,1,614
16/2/2021,Pahang,2170,701,2113,0,10,10,0,4,4,80,1,1077
16/2/2021,Perak,2728,359,2656,2,15,17,2,14,16,127,8,1624
16/2/2021,Perlis,508,57,493,1,0,1,2,0,2,3,10,278
16/2/2021,Pulau Pinang,1292,224,1249,0,24,24,0,21,21,126,0,685
16/2/2021,Sabah,2948,1255,2801,23,57,80,6,39,45,312,67,1144
16/2/2021,Sarawak,3054,866,2970,57,75,132,54,115,169,318,207,1403
16/2/2021,Selangor,5161,1304,4933,127,92,219,132,110,242,470,358,2543
16/2/2021,Terengganu,1307,288,1290,8,16,24,5,18,23,106,22,693
16/2/2021,W.P. Kuala Lumpur,3113,738,3046,4,20,24,5,24,29,256,51,1213
16/2/2021,W.P. Labuan,122,25,112,2,0,2,0,3,3,7,3,66
17/2/2021,Johor,4550,943,4432,107,100,207,90,56,146,478,180,42
17/2/2021,Kedah,1924,426,1863,1,18,19,0,77,77,170,7,1360
17/2/2021,Kelantan,2686,398,2557,1,9,10,0,35,35,141,1,1453
17/2/2021,Melaka,1101,231,1048,3,10,13,1,8,9,68,16,34
17/2/2021,Negeri Sembilan,1331,633,1284,2,12,14,0,16,16,152,2,650
17/2/2021,Pahang,2170,701,2113,0,10,10,1,3,4,83,2,1139
17/2/2021,Perak,2728,359,2656,2,10,12,2,17,19,125,7,1678
17/2/2021,Perlis,508,57,493,0,0,0,2,0,2,3,8,279
17/2/2021,Pulau Pinang,1292,224,1249,0,18,18,0,16,16,125,0,720
17/2/2021,Sabah,2948,1255,2801,9,45,54,7,14,21,312,70,1286
17/2/2021,Sarawak,3054,866,2970,73,256,329,49,88,137,289,224,1476
17/2/2021,Selangor,5161,1304,4933,167,131,298,104,105,209,467,382,2631
17/2/2021,Terengganu,1307,288,1290,2,16,18,5,12,17,110,17,695
17/2/2021,W.P. Kuala Lumpur,3997,798,3930,6,23,29,3,31,34,274,56,1526
17/2/2021,W.P. Labuan,122,25,112,1,0,1,0,2,2,5,4,61
18/2/2021,Johor,4550,952,4432,95,64,159,107,53,160,482,150,42
18/2/2021,Kedah,1924,426,1863,1,1,2,0,28,28,149,6,1348
18/2/2021,Kelantan,2686,398,2557,1,29,30,1,26,27,138,2,1441
18/2/2021,Melaka,1101,231,1048,1,5,6,2,16,18,59,14,814
18/2/2021,Negeri Sembilan,1331,633,1284,1,9,10,0,20,20,142,3,657
18/2/2021,Pahang,2170,701,2113,2,39,41,0,65,65,103,4,1163
18/2/2021,Perak,2728,359,2656,0,17,17,2,20,22,118,3,1762
18/2/2021,Perlis,508,57,493,1,0,1,0,0,0,3,9,275
18/2/2021,Pulau Pinang,1292,224,1249,0,14,14,0,13,13,124,0,756
18/2/2021,Sabah,2948,1150,2801,14,35,49,24,41,65,290,57,1308
18/2/2021,Sarawak,3054,866,2970,82,60,142,31,129,160,301,268,1499
18/2/2021,Selangor,5161,1304,4933,179,112,291,140,104,244,479,470,2565
18/2/2021,Terengganu,1307,288,1290,3,9,12,6,16,22,103,14,671
18/2/2021,W.P. Kuala Lumpur,3997,798,3930,3,24,27,8,45,53,253,65,1626
18/2/2021,W.P. Labuan,122,25,112,0,1,1,0,1,1,5,2,66
19/2/2021,Johor,4550,952,4432,75,75,150,63,50,113,475,146,45
19/2/2021,Kedah,1924,426,1863,3,9,12,0,17,17,147,7,1285
19/2/2021,Kelantan,2686,398,2557,2,29,31,1,16,17,150,3,1310
19/2/2021,Melaka,1101,231,1048,0,14,14,2,5,7,64,11,795
19/2/2021,Negeri Sembilan,1331,633,1284,0,23,23,0,19,19,142,3,651
19/2/2021,Pahang,2170,701,2113,2,18,20,2,8,10,113,4,1116
19/2/2021,Perak,2728,359,2656,3,22,25,1,28,29,109,8,1748
19/2/2021,Perlis,508,57,493,0,5,5,3,2,5,6,6,273
19/2/2021,Pulau Pinang,1292,224,1249,0,23,23,0,17,17,126,0,682
19/2/2021,Sabah,2948,1106,2801,7,27,34,16,44,60,265,48,1321
19/2/2021,Sarawak,3054,866,2970,53,228,281,71,105,176,296,248,1456
19/2/2021,Selangor,5161,1304,4933,194,141,335,124,165,289,470,441,2568
19/2/2021,Terengganu,1307,288,1290,2,10,12,2,9,11,104,14,690
19/2/2021,W.P. Kuala Lumpur,3997,798,3930,3,26,29,1,38,39,243,64,1573
19/2/2021,W.P. Labuan,122,25,112,0,0,0,1,1,2,5,1,71
20/2/2021,Johor,4550,952,4432,81,52,133,53,47,100,460,160,44
20/2/2021,Kedah,1924,426,1863,0,20,20,2,24,26,130,1,1277
20/2/2021,Kelantan,2686,398,2557,0,23,23,1,34,35,143,2,1294
20/2/2021,Melaka,1101,231,1048,2,15,17,1,14,15,62,12,753
20/2/2021,Negeri Sembilan,1331,633,1284,3,18,21,2,23,25,133,3,665
20/2/2021,Pahang,2170,701,2113,2,17,19,1,17,18,108,5,1068
20/2/2021,Perak,2728,359,2656,1,11,12,3,17,20,101,5,1611
20/2/2021,Perlis,508,57,493,0,0,0,1,0,1,6,5,268
20/2/2021,Pulau Pinang,1292,224,1249,0,28,28,0,23,23,133,0,724
20/2/2021,Sabah,2948,1106,2801,16,45,61,13,40,53,269,48,1196
20/2/2021,Sarawak,3054,866,2970,62,129,191,33,86,119,296,260,1428
20/2/2021,Selangor,5161,1304,4933,218,99,317,139,99,238,470,400,2556
20/2/2021,Terengganu,1307,288,1290,0,6,6,3,9,12,101,11,695
20/2/2021,W.P. Kuala Lumpur,3997,798,3930,3,42,45,8,41,49,240,46,1293
20/2/2021,W.P. Labuan,122,25,112,1,0,1,0,2,2,3,2,64
21/2/2021,Johor,4550,952,4432,82,51,133,61,28,89,470,163,43
21/2/2021,Kedah,1924,426,1863,0,10,10,0,17,17,141,3,1329
21/2/2021,Kelantan,2641,337,2512,2,46,48,1,19,20,178,2,1395
21/2/2021,Melaka,1101,231,1048,2,7,9,3,9,12,59,8,772
21/2/2021,Negeri Sembilan,1331,633,1284,0,12,12,0,20,20,121,3,585
21/2/2021,Pahang,2170,701,2113,0,7,7,0,9,9,111,1,1045
21/2/2021,Perak,2728,359,2656,0,17,17,0,13,13,104,4,1557
21/2/2021,Perlis,508,57,493,2,3,5,1,0,1,9,6,276
21/2/2021,Pulau Pinang,1292,224,1249,0,16,16,0,21,21,125,0,690
21/2/2021,Sabah,2948,1106,2801,14,34,48,11,17,28,260,47,1181
21/2/2021,Sarawak,3054,866,2970,50,43,93,45,184,229,296,274,1398
21/2/2021,Selangor,5161,1304,4933,129,91,220,121,90,211,463,451,2537
21/2/2021,Terengganu,1307,288,1290,3,8,11,3,23,26,86,11,750
21/2/2021,W.P. Kuala Lumpur,3997,798,3930,6,45,51,8,51,59,222,45,1336
21/2/2021,W.P. Labuan,122,25,112,0,0,0,0,0,0,3,2,59
22/2/2021,Johor,4550,952,4432,108,73,181,98,48,146,470,184,39
22/2/2021,Kedah,1924,426,1863,7,11,18,0,26,26,120,11,1377
22/2/2021,Kelantan,2641,337,2512,1,17,18,1,8,9,186,2,1453
22/2/2021,Melaka,1101,231,1048,0,6,6,2,2,4,63,6,747
22/2/2021,Negeri Sembilan,1331,633,1284,0,8,8,0,14,14,115,3,590
22/2/2021,Pahang,2170,701,2113,2,3,5,2,12,14,102,4,1126
22/2/2021,Perak,2728,359,2656,1,15,16,0,9,9,113,3,1649
22/2/2021,Perlis,508,57,493,1,0,1,2,0,2,9,5,270
22/2/2021,Pulau Pinang,1292,224,1249,0,12,12,0,15,15,123,0,761
22/2/2021,Sabah,2948,1106,2801,13,30,43,6,24,30,265,54,1237
22/2/2021,Sarawak,3054,866,2970,139,78,217,20,73,93,281,379,1400
22/2/2021,Selangor,5161,1304,4933,161,96,257,103,77,180,490,508,2560
22/2/2021,Terengganu,1307,288,1290,2,5,7,2,7,9,82,11,779
22/2/2021,W.P. Kuala Lumpur,3997,798,3930,0,21,21,1,22,23,228,65,1582
22/2/2021,W.P. Labuan,122,25,112,2,0,2,0,0,0,3,4,72
23/2/2021,Johor,4550,952,4432,118,61,179,93,27,120,483,157,38
23/2/2021,Kedah,1924,426,1863,1,13,14,0,20,20,118,8,1391
23/2/2021,Kelantan,2641,337,2512,0,26,26,2,27,29,183,0,1510
23/2/2021,Melaka,1101,231,1048,2,3,5,1,4,5,60,8,773
23/2/2021,Negeri Sembilan,1331,633,1284,1,18,19,2,21,23,112,2,669
23/2/2021,Pahang,2170,701,2113,0,4,4,1,11,12,101,3,1215
23/2/2021,Perak,2728,359,2656,0,43,43,0,14,14,137,3,1746
23/2/2021,Perlis,508,57,493,0,0,0,2,1,3,8,3,293
23/2/2021,Pulau Pinang,1292,224,1249,0,11,11,0,17,17,108,0,792
23/2/2021,Sabah,2948,966,2801,12,27,39,8,25,33,264,56,1330
23/2/2021,Sarawak,3054,866,2970,89,166,255,48,181,229,290,385,1389
23/2/2021,Selangor,5161,1304,4933,162,80,242,121,107,228,458,483,2658
23/2/2021,Terengganu,1307,288,1290,1,0,1,1,6,7,76,11,695
23/2/2021,W.P. Kuala Lumpur,3997,798,3930,5,10,15,6,15,21,224,65,1653
23/2/2021,W.P. Labuan,122,25,112,0,0,0,0,1,1,2,5,82
24/2/2021,Johor,4550,952,4432,86,25,111,81,65,146,490,134,44
24/2/2021,Kedah,1924,418,1863,0,8,8,0,25,25,98,7,1395
24/2/2021,Kelantan,2641,337,2512,3,39,42,1,25,26,199,1,1491
24/2/2021,Melaka,1101,231,1048,5,7,12,1,10,11,57,12,780
24/2/2021,Negeri Sembilan,1331,633,1284,0,11,11,0,7,7,117,0,628
24/2/2021,Pahang,2170,701,2113,0,2,2,2,7,9,92,1,1126
24/2/2021,Perak,2728,359,2656,1,6,7,2,18,20,122,4,1767
24/2/2021,Perlis,508,57,493,3,0,3,3,0,3,8,3,284
24/2/2021,Pulau Pinang,1292,248,1249,0,22,22,0,17,17,112,0,814
24/2/2021,Sabah,2948,966,2801,7,36,43,21,21,42,259,43,1389
24/2/2021,Sarawak,3054,870,2970,49,133,182,79,125,204,292,349,1447
24/2/2021,Selangor,5161,1304,4933,161,73,234,99,79,178,455,461,2687
24/2/2021,Terengganu,1307,288,1290,4,4,8,4,23,27,57,11,768
24/2/2021,W.P. Kuala Lumpur,3997,773,3930,2,10,12,9,23,32,215,67,1640
24/2/2021,W.P. Labuan,122,25,112,0,0,0,0,0,0,2,5,81
25/2/2021,Johor,4550,952,4432,123,59,182,73,38,111,486,152,48
25/2/2021,Kedah,1924,418,1863,0,4,4,1,20,21,81,6,1431
25/2/2021,Kelantan,2641,337,2512,0,23,23,3,19,22,197,0,1395
25/2/2021,Melaka,1101,231,1048,3,3,6,4,7,11,53,9,36
25/2/2021,Negeri Sembilan,1331,633,1284,7,19,26,0,21,21,115,7,632
25/2/2021,Pahang,2170,701,2113,0,8,8,0,26,26,74,1,1162
25/2/2021,Perak,2728,359,2656,2,15,17,0,25,25,114,4,1811
25/2/2021,Perlis,508,57,493,0,0,0,2,0,2,8,2,272
25/2/2021,Pulau Pinang,1292,248,1249,0,38,38,0,23,23,127,0,797
25/2/2021,Sabah,2948,966,2801,9,30,39,21,26,47,242,31,1363
25/2/2021,Sarawak,3054,870,2970,57,172,229,51,211,262,296,133,1539
25/2/2021,Selangor,5161,1304,4933,149,61,210,144,113,257,402,450,2715
25/2/2021,Terengganu,1307,288,1287,6,5,11,5,11,16,50,12,709
25/2/2021,W.P. Kuala Lumpur,3997,773,3930,3,15,18,7,31,38,188,62,1689
25/2/2021,W.P. Labuan,122,25,112,0,0,0,0,1,1,2,1,86
26/2/2021,Johor,4550,952,4432,108,51,159,82,52,134,451,139,45
26/2/2021,Kedah,1924,418,1863,3,5,8,0,6,6,84,8,1317
26/2/2021,Kelantan,2641,337,2512,2,30,32,0,24,24,205,0,1305
26/2/2021,Melaka,1101,165,1048,3,8,11,0,11,11,50,12,785
26/2/2021,Negeri Sembilan,1331,633,1284,2,13,15,3,10,13,118,6,581
26/2/2021,Pahang,2170,701,2113,0,19,19,0,13,13,78,1,1119
26/2/2021,Perak,2728,359,2656,2,26,28,1,8,9,132,6,1815
26/2/2021,Perlis,508,57,493,1,0,1,0,5,5,3,2,280
26/2/2021,Pulau Pinang,1292,248,1249,0,24,24,0,3,3,152,0,771
26/2/2021,Sabah,2948,966,2801,10,22,32,8,31,39,246,39,1409
26/2/2021,Sarawak,3054,870,2970,56,293,349,80,114,194,325,112,1394
26/2/2021,Selangor,5161,1316,4933,170,67,237,94,84,178,398,415,2388
26/2/2021,Terengganu,1307,288,1287,14,3,17,1,4,5,49,25,714
26/2/2021,W.P. Kuala Lumpur,3997,723,3930,4,18,22,7,29,36,180,56,1579
26/2/2021,W.P. Labuan,122,25,112,0,1,1,0,1,1,2,1,64
27/2/2021,Johor,4550,952,4432,111,77,188,90,21,111,454,124,42
27/2/2021,Kedah,1924,418,1863,1,8,9,0,16,16,77,7,1341
27/2/2021,Kelantan,2641,337,2512,1,33,34,2,22,24,203,1,1297
27/2/2021,Melaka,1101,165,1048,3,9,12,2,5,7,54,11,710
27/2/2021,Negeri Sembilan,1331,633,1284,0,18,18,2,17,19,119,4,575
27/2/2021,Pahang,2170,701,2113,0,3,3,0,18,18,62,1,1107
27/2/2021,Perak,2728,359,2656,0,9,9,0,18,18,121,6,1705
27/2/2021,Perlis,508,57,493,0,1,1,0,0,0,4,3,268
27/2/2021,Pulau Pinang,1292,248,1249,0,20,20,0,18,18,153,0,709
27/2/2021,Sabah,2948,966,2805,11,36,47,11,43,54,226,39,1349
27/2/2021,Sarawak,3054,870,2970,42,69,111,83,196,279,330,110,1334
27/2/2021,Selangor,5161,1316,4933,149,68,217,99,84,183,385,452,2630
27/2/2021,Terengganu,1307,288,1287,18,1,19,2,4,6,46,41,744
27/2/2021,W.P. Kuala Lumpur,3997,723,3930,16,24,40,15,57,72,181,56,1529
27/2/2021,W.P. Labuan,122,25,112,0,0,0,0,0,0,2,1,75
28/2/2021,Johor,4550,952,4432,97,26,123,60,42,102,444,154,42
28/2/2021,Kedah,1924,418,1863,3,0,3,0,16,16,62,9,1342
28/2/2021,Kelantan,2641,337,2512,0,28,28,1,38,39,194,0,1381
28/2/2021,Melaka,1101,165,1048,3,2,5,5,10,15,46,11,681
28/2/2021,Negeri Sembilan,1331,633,1284,3,6,9,1,5,6,117,6,593
28/2/2021,Pahang,2170,701,2113,0,1,1,0,3,3,60,0,1085
28/2/2021,Perak,2728,359,2656,3,26,29,0,17,17,131,7,1651
28/2/2021,Perlis,508,57,493,0,0,0,1,0,1,4,2,257
28/2/2021,Pulau Pinang,1292,248,1249,0,10,10,0,19,19,137,0,679
28/2/2021,Sabah,2948,966,2805,5,28,33,8,23,31,219,38,1326
28/2/2021,Sarawak,3054,870,2968,47,205,252,55,187,242,338,116,1340
28/2/2021,Selangor,5161,1316,4933,147,72,219,82,59,141,398,442,2622
28/2/2021,Terengganu,1307,288,1287,0,2,2,5,9,14,39,36,841
28/2/2021,W.P. Kuala Lumpur,3997,723,3930,4,10,14,8,21,29,141,55,1481
28/2/2021,W.P. Labuan,122,25,112,0,0,0,0,0,0,1,1,64
1/3/2021,Johor,4550,952,4432,108,39,147,68,44,112,417,154,41
1/3/2021,Kedah,1924,418,1863,2,6,8,1,12,13,61,6,1383
1/3/2021,Kelantan,2641,337,2512,1,18,19,0,26,26,187,1,1406
1/3/2021,Melaka,1101,165,1048,1,3,4,1,4,5,45,11,702
1/3/2021,Negeri Sembilan,1251,503,1204,0,12,12,1,15,16,110,6,620
1/3/2021,Pahang,2170,701,2113,0,5,5,0,8,8,57,1,1084
1/3/2021,Perak,2728,359,2656,0,12,12,0,14,14,121,6,1712
1/3/2021,Perlis,508,57,493,0,0,0,1,3,4,1,1,275
1/3/2021,Pulau Pinang,1292,248,1249,0,7,7,0,16,16,124,0,722
1/3/2021,Sabah,2948,966,2805,5,19,24,5,20,25,217,37,1360
1/3/2021,Sarawak,3054,870,2968,42,151,193,60,186,246,356,68,1357
1/3/2021,Selangor,5161,1316,4933,120,80,200,112,79,191,399,398,2647
1/3/2021,Terengganu,1307,288,1287,3,7,10,7,6,13,40,33,835
1/3/2021,W.P. Kuala Lumpur,3997,723,3930,2,9,11,4,12,16,138,50,1595
1/3/2021,W.P. Labuan,122,25,112,0,0,0,0,0,0,1,1,65
2/3/2021,Johor,4550,952,4432,97,45,142,80,60,140,386,147,2941
2/3/2021,Kedah,1924,418,1863,0,9,9,0,15,15,55,3,1411
2/3/2021,Kelantan,2641,337,2512,0,13,13,0,23,23,177,1,1485
2/3/2021,Melaka,1101,165,1048,1,4,5,6,3,9,46,6,752
2/3/2021,Negeri Sembilan,1251,503,1204,0,9,9,2,16,18,104,3,656
2/3/2021,Pahang,2170,701,2113,0,6,6,1,8,9,53,0,1161
2/3/2021,Perak,2728,359,2656,0,8,8,0,16,16,110,10,1701
2/3/2021,Perlis,508,57,493,1,0,1,0,0,0,1,2,303
2/3/2021,Pulau Pinang,1292,248,1249,0,14,14,0,13,13,124,0,790
2/3/2021,Sabah,2948,932,2815,6,25,31,8,18,26,217,37,1361
2/3/2021,Sarawak,3054,870,2968,62,180,242,37,225,262,360,108,1804
2/3/2021,Selangor,5161,1316,4933,159,87,246,132,66,198,422,498,2717
2/3/2021,Terengganu,1307,288,1287,3,3,6,9,8,17,35,27,894
2/3/2021,W.P. Kuala Lumpur,3997,723,3930,1,20,21,5,14,19,139,40,1675
2/3/2021,W.P. Labuan,122,25,112,0,0,0,0,0,0,1,1,60
3/3/2021,Johor,4550,952,4432,101,43,144,70,35,105,386,143,2901
3/3/2021,Kedah,1924,418,1863,0,6,6,0,14,14,47,2,1428
3/3/2021,Kelantan,2641,337,2512,0,23,23,1,29,30,181,0,1475
3/3/2021,Melaka,1101,165,1048,0,7,7,1,7,8,46,5,775
3/3/2021,Negeri Sembilan,1251,503,1204,1,28,29,1,17,18,114,3,656
3/3/2021,Pahang,2170,701,2113,0,1,1,0,4,4,51,0,1183
3/3/2021,Perak,2728,359,2656,1,9,10,3,15,18,105,6,1768
3/3/2021,Perlis,508,57,493,4,0,4,1,0,1,1,4,311
3/3/2021,Pulau Pinang,1292,248,1249,0,15,15,0,14,14,126,0,815
3/3/2021,Sabah,2948,932,2815,9,30,39,4,19,23,222,39,1346
3/3/2021,Sarawak,3054,870,2967,70,96,166,64,137,201,335,101,1479
3/3/2021,Selangor,5161,1316,4933,181,65,246,114,78,192,414,448,2777
3/3/2021,Terengganu,1307,288,1287,5,5,10,6,5,11,35,26,809
3/3/2021,W.P. Kuala Lumpur,3997,705,3930,2,3,5,4,19,23,124,28,1777
3/3/2021,W.P. Labuan,122,25,112,5,0,5,0,1,1,1,6,74
4/3/2021,Johor,4550,952,4432,74,40,114,48,31,79,384,141,2888
4/3/2021,Kedah,1924,338,1863,2,3,5,2,8,10,53,2,1376
4/3/2021,Kelantan,2641,337,2512,0,19,19,0,24,24,173,0,1456
4/3/2021,Melaka,1101,165,1048,0,7,7,1,2,3,51,4,30
4/3/2021,Negeri Sembilan,1251,503,1204,0,5,5,0,14,14,104,3,666
4/3/2021,Pahang,2170,701,2113,2,8,10,0,7,7,52,2,1162
4/3/2021,Perak,2728,359,2656,1,9,10,1,12,13,99,7,1796
4/3/2021,Perlis,508,57,493,0,1,1,0,0,0,2,3,317
4/3/2021,Pulau Pinang,1292,248,1249,0,11,11,0,20,20,121,0,812
4/3/2021,Sabah,2948,932,2823,12,44,56,10,19,29,237,35,1419
4/3/2021,Sarawak,3054,870,2967,29,131,160,47,200,247,352,88,1475
4/3/2021,Selangor,5161,1316,4933,159,58,217,119,88,207,386,450,2803
4/3/2021,Terengganu,1307,288,1287,1,7,8,4,3,7,39,25,772
4/3/2021,W.P. Kuala Lumpur,3997,705,3930,3,2,5,8,8,16,109,25,1873
4/3/2021,W.P. Labuan,122,25,112,0,0,0,0,0,0,1,3,79
5/3/2021,Johor,4550,952,4432,100,55,155,71,44,115,370,155,2772
5/3/2021,Kedah,1924,338,1863,3,5,8,0,6,6,42,4,1318
5/3/2021,Kelantan,2641,337,2512,0,18,18,0,23,23,169,0,1346
5/3/2021,Melaka,1101,165,1048,3,2,5,1,10,11,43,6,829
5/3/2021,Negeri Sembilan,1251,503,1204,4,11,15,3,13,16,101,4,668
5/3/2021,Pahang,2170,701,2113,2,3,5,1,9,10,43,3,1202
5/3/2021,Perak,2728,359,2656,0,11,11,2,29,31,82,4,1753
5/3/2021,Perlis,508,57,493,0,1,1,1,0,1,3,2,325
5/3/2021,Pulau Pinang,1292,248,1249,0,15,15,0,38,38,109,0,823
5/3/2021,Sabah,2948,932,2823,9,34,43,5,24,29,220,42,1383
5/3/2021,Sarawak,3054,870,2967,60,264,324,51,158,209,366,94,1467
5/3/2021,Selangor,5161,1316,4933,195,75,270,115,94,209,372,435,2841
5/3/2021,Terengganu,1307,288,1287,4,4,8,3,5,8,38,26,756
5/3/2021,W.P. Kuala Lumpur,3997,705,3930,4,10,14,6,21,27,101,25,1940
5/3/2021,W.P. Labuan,122,25,112,1,0,1,1,0,1,2,4,76
6/3/2021,Johor,4550,952,4432,105,53,158,45,34,79,377,144,2718
6/3/2021,Kedah,1924,338,1863,4,5,9,0,4,4,44,7,1317
6/3/2021,Kelantan,2641,337,2512,3,11,14,0,28,28,152,0,1329
6/3/2021,Melaka,1101,165,1048,1,1,2,0,5,5,39,7,761
6/3/2021,Negeri Sembilan,1251,503,1204,0,10,10,0,23,23,96,3,675
6/3/2021,Pahang,2170,701,2113,2,5,7,2,7,9,39,3,1177
6/3/2021,Perak,2728,359,2656,0,5,5,1,18,19,69,4,1649
6/3/2021,Perlis,508,57,493,5,0,5,1,0,1,3,7,319
6/3/2021,Pulau Pinang,1292,248,1249,0,16,16,0,20,20,95,0,776
6/3/2021,Sabah,2948,932,2823,10,16,26,17,31,48,205,33,1216
6/3/2021,Sarawak,3054,870,2967,56,247,303,50,252,302,347,90,1170
6/3/2021,Selangor,5161,1366,4933,181,73,254,99,87,186,365,553,2705
6/3/2021,Terengganu,1231,212,1211,1,4,5,4,3,7,39,24,719
6/3/2021,W.P. Kuala Lumpur,3997,705,3930,1,8,9,0,15,15,91,28,1836
6/3/2021,W.P. Labuan,122,25,112,0,2,2,0,0,0,3,2,69
7/3/2021,Johor,4550,952,4432,145,25,170,71,20,91,362,132,2842
7/3/2021,Kedah,1844,215,1783,0,4,4,0,4,4,48,4,1372
7/3/2021,Kelantan,2497,327,2373,2,17,19,1,32,33,137,3,1254
7/3/2021,Melaka,1101,165,1048,1,2,3,0,11,11,30,8,727
7/3/2021,Negeri Sembilan,1251,503,1204,0,24,24,1,9,10,102,3,647
7/3/2021,Pahang,2170,701,2113,2,1,3,1,3,4,37,4,1136
7/3/2021,Perak,2728,359,2656,0,12,12,0,11,11,70,5,1549
7/3/2021,Perlis,508,57,493,6,6,12,2,0,2,7,8,308
7/3/2021,Pulau Pinang,1292,248,1249,0,17,17,0,15,15,95,0,730
7/3/2021,Sabah,2948,932,2823,10,12,22,6,22,28,199,36,1310
7/3/2021,Sarawak,3054,870,2967,62,169,231,50,187,237,325,88,1365
7/3/2021,Selangor,5161,1366,4933,192,70,262,124,84,208,354,485,2684
7/3/2021,Terengganu,1231,212,1211,2,4,6,6,2,8,41,20,785
7/3/2021,W.P. Kuala Lumpur,3997,705,3930,4,6,10,4,13,17,87,23,1801
7/3/2021,W.P. Labuan,122,25,112,2,0,2,1,1,2,2,3,67
8/3/2021,Johor,4550,952,4432,99,75,174,56,43,99,371,131,2890
8/3/2021,Kedah,1844,215,1783,1,5,6,2,5,7,47,3,1410
8/3/2021,Kelantan,2497,327,2373,0,12,12,4,21,25,127,0,1349
8/3/2021,Melaka,1101,165,1048,0,2,2,1,3,4,29,7,733
8/3/2021,Negeri Sembilan,1251,503,1204,1,8,9,0,10,10,102,3,641
8/3/2021,Pahang,2170,701,2113,2,7,9,2,6,8,37,4,1233
8/3/2021,Perak,2728,359,2656,0,9,9,1,16,17,65,2,1638
8/3/2021,Perlis,508,57,493,5,7,12,1,0,1,14,6,317
8/3/2021,Pulau Pinang,1292,248,1249,0,18,18,0,14,14,96,0,766
8/3/2021,Sabah,2948,932,2823,5,14,19,10,16,26,195,31,1321
8/3/2021,Sarawak,3054,870,2967,52,107,159,51,157,208,325,86,1393
8/3/2021,Selangor,5161,1366,4933,195,60,255,127,72,199,342,485,2686
8/3/2021,Terengganu,1231,212,1211,1,3,4,3,4,7,39,18,829
8/3/2021,W.P. Kuala Lumpur,3997,700,3930,4,3,7,3,7,10,83,6,1885
8/3/2021,W.P. Labuan,122,25,112,0,1,1,2,1,3,2,1,72
9/3/2021,Johor,4550,952,4432,95,29,124,62,20,82,364,162,2951
9/3/2021,Kedah,1844,215,1783,2,9,11,0,6,6,55,3,1377
9/3/2021,Kelantan,2497,327,2373,1,14,15,0,13,13,128,1,1385
9/3/2021,Melaka,1101,125,1048,0,2,2,4,4,8,27,3,36
9/3/2021,Negeri Sembilan,1251,503,1204,0,9,9,0,11,11,99,0,676
9/3/2021,Pahang,2170,701,2113,1,2,3,1,9,10,30,4,1238
9/3/2021,Perak,2728,359,2656,0,10,10,0,11,11,64,3,1748
9/3/2021,Perlis,508,57,493,3,0,3,0,0,0,9,9,339
9/3/2021,Pulau Pinang,1292,248,1249,0,22,22,0,13,13,107,0,841
9/3/2021,Sabah,2948,932,2823,13,15,28,6,33,39,191,36,1442
9/3/2021,Sarawak,3054,870,2967,52,152,204,71,130,201,339,74,1439
9/3/2021,Selangor,5161,1330,4933,165,65,230,99,72,171,331,384,3168
9/3/2021,Terengganu,1231,212,1211,10,3,13,2,3,5,39,26,850
9/3/2021,W.P. Kuala Lumpur,3997,690,3930,3,5,8,2,12,14,76,17,1907
9/3/2021,W.P. Labuan,122,25,112,0,0,0,1,0,1,2,0,78
10/3/2021,Johor,4550,952,4432,98,40,138,74,25,99,348,140,2959
10/3/2021,Kedah,1844,215,1783,3,5,8,0,9,9,47,6,1398
10/3/2021,Kelantan,2497,327,2373,1,11,12,1,24,25,113,1,1339
10/3/2021,Melaka,1101,125,1048,0,1,1,2,6,8,22,1,815
10/3/2021,Negeri Sembilan,1251,503,1204,2,6,8,1,11,12,93,4,701
10/3/2021,Pahang,2170,701,2113,0,0,0,1,4,5,26,3,1296
10/3/2021,Perak,2728,359,2656,0,9,9,0,6,6,69,1,1853
10/3/2021,Perlis,508,57,493,1,0,1,1,0,1,9,9,325
10/3/2021,Pulau Pinang,1292,248,1249,0,15,15,0,6,6,114,0,707
10/3/2021,Sabah,2948,932,2823,16,23,39,6,16,22,191,44,1453
10/3/2021,Sarawak,3054,870,2967,70,280,350,56,109,165,347,100,1419
10/3/2021,Selangor,5161,1330,4933,192,67,259,116,71,187,353,456,2787
10/3/2021,Terengganu,1231,212,1211,7,10,17,8,2,10,47,25,823
10/3/2021,W.P. Kuala Lumpur,3997,358,3930,3,8,11,4,7,11,77,18,1950
10/3/2021,W.P. Labuan,122,25,112,0,0,0,0,0,0,2,0,77
11/3/2021,Johor,4550,952,4432,118,37,155,70,28,98,337,150,2961
11/3/2021,Kedah,1844,215,1783,2,6,8,0,6,6,50,5,1387
11/3/2021,Kelantan,2497,327,2373,4,12,16,1,12,13,108,4,1361
11/3/2021,Melaka,1101,125,1048,1,0,1,0,8,8,14,2,826
11/3/2021,Negeri Sembilan,1251,503,1204,1,5,6,0,19,19,78,5,713
11/3/2021,Pahang,2170,701,2113,2,2,4,3,8,11,20,3,1232
11/3/2021,Perak,2728,359,2656,1,6,7,0,7,7,68,3,1871
11/3/2021,Perlis,508,57,493,2,2,4,4,0,4,10,7,312
11/3/2021,Pulau Pinang,1292,248,1249,0,22,22,0,13,13,121,0,777
11/3/2021,Sabah,2948,817,2823,11,24,35,5,21,26,170,41,1534
11/3/2021,Sarawak,3054,870,2967,58,123,181,69,258,327,345,91,1476
11/3/2021,Selangor,5161,1330,4933,138,57,195,106,90,196,362,303,1953
11/3/2021,Terengganu,1231,212,1211,6,4,10,1,5,6,46,30,815
11/3/2021,W.P. Kuala Lumpur,3997,326,3930,1,8,9,4,13,17,72,14,1908
11/3/2021,W.P. Labuan,122,25,112,0,0,0,0,0,0,2,1,71
12/3/2021,Johor,4550,952,4432,101,45,146,63,37,100,336,148,2835
12/3/2021,Kedah,1844,215,1783,3,7,10,1,4,5,48,4,1385
12/3/2021,Kelantan,2497,327,2373,1,19,20,2,22,24,106,3,1248
12/3/2021,Melaka,1101,125,1048,0,10,10,1,3,4,21,1,833
12/3/2021,Negeri Sembilan,1251,503,1204,1,6,7,1,8,9,76,5,675
12/3/2021,Pahang,2170,701,2113,0,1,1,1,0,1,20,2,1252
12/3/2021,Perak,2728,359,2656,0,5,5,0,7,7,67,2,1833
12/3/2021,Perlis,508,57,493,1,0,1,2,0,2,10,6,315
12/3/2021,Pulau Pinang,1292,248,1249,0,20,20,0,6,6,129,0,801
12/3/2021,Sabah,2948,817,2823,12,19,31,19,24,43,164,38,1511
12/3/2021,Sarawak,3054,870,2967,58,145,203,50,173,223,339,133,1469
12/3/2021,Selangor,4742,1210,4532,132,75,207,99,71,170,338,302,2548
12/3/2021,Terengganu,1231,212,1211,1,1,2,7,3,10,44,24,731
12/3/2021,W.P. Kuala Lumpur,3997,316,3930,1,2,3,1,3,4,74,21,1867
12/3/2021,W.P. Labuan,122,25,112,0,1,1,0,0,0,3,1,68
13/3/2021,Johor,4550,952,4432,113,28,141,69,31,100,312,142,2841
13/3/2021,Kedah,1844,215,1783,2,7,9,0,6,6,50,3,1375
13/3/2021,Kelantan,2497,327,2373,0,22,22,1,31,32,105,0,1247
13/3/2021,Melaka,1101,125,1048,1,5,6,1,6,7,20,1,767
13/3/2021,Negeri Sembilan,1251,503,1204,0,4,4,3,7,10,74,2,652
13/3/2021,Pahang,2170,701,2113,0,1,1,0,6,6,16,2,1191
13/3/2021,Perak,2728,359,2656,0,8,8,0,10,10,64,4,1702
13/3/2021,Perlis,508,57,493,0,3,3,1,0,1,9,5,333
13/3/2021,Pulau Pinang,1292,248,1249,0,15,15,0,13,13,118,0,735
13/3/2021,Sabah,2948,817,2823,7,28,35,6,18,24,169,34,1247
13/3/2021,Sarawak,3054,870,2967,41,140,181,48,216,264,343,85,1365
13/3/2021,Selangor,4742,1210,4532,147,76,223,87,93,180,322,310,2411
13/3/2021,Terengganu,1231,212,1211,9,3,12,5,11,16,35,28,752
13/3/2021,W.P. Kuala Lumpur,3997,316,3930,5,2,7,1,9,10,68,28,1731
13/3/2021,W.P. Labuan,122,25,112,0,0,0,0,1,1,2,1,72
14/3/2021,Johor,4550,952,4432,93,39,132,61,22,83,318,143,2936
14/3/2021,Kedah,1844,215,1783,2,7,9,0,4,4,57,4,1443
14/3/2021,Kelantan,2497,327,2373,0,30,30,0,26,26,111,0,1335
14/3/2021,Melaka,1101,125,1048,0,2,2,0,1,1,21,1,751
14/3/2021,Negeri Sembilan,1251,503,1204,1,3,4,0,8,8,69,3,645
14/3/2021,Pahang,2170,701,2113,2,9,11,1,9,10,16,3,1191
14/3/2021,Perak,2728,359,2656,1,7,8,0,7,7,65,5,1646
14/3/2021,Perlis,508,57,493,1,0,1,1,3,4,11,5,343
14/3/2021,Pulau Pinang,1292,248,1249,0,16,16,0,15,15,120,0,699
14/3/2021,Sabah,2948,817,2823,10,34,44,5,11,16,177,39,1380
14/3/2021,Sarawak,3054,870,2967,73,174,247,41,131,172,335,90,1444
14/3/2021,Selangor,4742,1210,4532,105,58,163,95,77,172,322,403,2305
14/3/2021,Terengganu,1231,212,1211,6,8,14,1,10,11,33,32,804
14/3/2021,W.P. Kuala Lumpur,3997,316,3930,5,4,9,5,9,14,62,33,1692
14/3/2021,W.P. Labuan,122,25,112,1,0,1,0,0,0,2,2,67
15/3/2021,Johor,4550,952,4432,126,39,165,67,46,113,295,175,2998
15/3/2021,Kedah,1844,215,1783,6,5,11,0,12,12,52,9,1490
15/3/2021,Kelantan,2497,296,2373,0,13,13,0,10,10,114,0,1417
15/3/2021,Melaka,1101,125,1048,1,0,1,0,0,0,21,2,803
15/3/2021,Negeri Sembilan,1251,503,1204,0,0,0,0,11,11,58,3,679
15/3/2021,Pahang,2170,701,2113,3,7,10,3,9,12,14,4,1144
15/3/2021,Perak,2728,359,2656,0,7,7,0,11,11,61,4,1707
15/3/2021,Perlis,508,57,493,2,0,2,0,2,2,13,7,349
15/3/2021,Pulau Pinang,1292,248,1249,0,25,25,0,10,10,134,0,687
15/3/2021,Sabah,2948,817,2823,6,14,20,9,18,27,156,31,1468
15/3/2021,Sarawak,3054,870,2967,82,128,210,52,169,221,339,94,1447
15/3/2021,Selangor,4742,1212,4532,87,58,145,115,76,191,306,350,2321
15/3/2021,Terengganu,1231,212,1211,7,10,17,7,2,9,41,32,878
15/3/2021,W.P. Kuala Lumpur,3997,316,3930,1,3,4,2,9,11,53,31,1825
15/3/2021,W.P. Labuan,122,25,112,0,0,0,1,1,2,1,1,66
16/3/2021,Johor,4550,952,4432,115,39,154,84,20,104,312,166,3097
16/3/2021,Kedah,1844,215,1783,2,19,21,1,6,7,66,5,1523
16/3/2021,Kelantan,2497,296,2373,0,19,19,0,21,21,110,0,1426
16/3/2021,Melaka,1101,125,1048,0,1,1,1,2,3,20,1,821
16/3/2021,Negeri Sembilan,1251,503,1204,0,9,9,2,16,18,52,1,737
16/3/2021,Pahang,2170,701,2113,1,0,1,0,0,0,14,5,1320
16/3/2021,Perak,2728,359,2656,4,7,11,0,14,14,55,7,1787
16/3/2021,Perlis,508,57,493,3,0,3,2,0,2,13,8,352
16/3/2021,Pulau Pinang,1292,248,1249,0,15,15,0,17,17,122,0,770
16/3/2021,Sabah,2948,817,2823,8,18,26,7,19,26,155,31,1527
16/3/2021,Sarawak,3054,870,2967,73,186,259,63,177,240,335,95,1505
16/3/2021,Selangor,4742,1212,4532,83,68,151,105,82,187,297,305,2503
16/3/2021,Terengganu,1231,212,1211,2,11,13,6,2,8,50,29,797
16/3/2021,W.P. Kuala Lumpur,3997,316,3930,6,2,8,2,6,8,49,30,2009
16/3/2021,W.P. Labuan,122,25,112,0,0,0,0,0,0,1,2,83
17/3/2021,Johor,4550,952,4432,113,33,146,64,23,87,324,145,3096
17/3/2021,Kedah,1844,215,1783,3,12,15,0,6,6,75,5,1494
17/3/2021,Kelantan,2497,296,2373,0,33,33,0,10,10,132,0,1472
17/3/2021,Melaka,1101,125,1048,0,0,0,0,0,0,20,1,896
17/3/2021,Negeri Sembilan,1251,503,1204,0,10,10,0,12,12,50,1,790
17/3/2021,Pahang,2170,701,2113,18,0,18,0,0,0,14,31,1267
17/3/2021,Perak,2728,359,2656,0,14,14,3,12,15,59,5,1840
17/3/2021,Perlis,508,57,493,1,0,1,0,0,0,13,9,379
17/3/2021,Pulau Pinang,1292,248,1249,0,15,15,0,16,16,124,0,741
17/3/2021,Sabah,2948,817,2823,9,11,20,9,21,30,137,25,1413
17/3/2021,Sarawak,3054,870,2967,46,126,172,39,180,219,314,86,1480
17/3/2021,Selangor,4742,1212,4532,81,71,152,127,68,195,312,384,2579
17/3/2021,Terengganu,1231,212,1211,1,9,10,10,5,15,54,19,770
17/3/2021,W.P. Kuala Lumpur,3997,316,3930,1,5,6,1,5,6,48,28,2016
17/3/2021,W.P. Labuan,122,25,112,0,0,0,0,0,0,1,2,76
18/3/2021,Johor,4550,952,4432,122,52,174,74,25,99,363,153,3044
18/3/2021,Kedah,1844,215,1783,5,14,19,0,6,6,84,10,1469
18/3/2021,Kelantan,2497,296,2373,1,11,12,0,13,13,129,1,1427
18/3/2021,Melaka,1101,125,1048,1,1,2,1,2,3,19,1,871
18/3/2021,Negeri Sembilan,1251,503,1204,0,12,12,1,8,9,54,0,763
18/3/2021,Pahang,2170,701,2113,14,0,14,4,0,4,14,41,1364
18/3/2021,Perak,2728,359,2656,0,9,9,0,10,10,59,4,1844
18/3/2021,Perlis,508,57,493,1,0,1,4,0,4,13,7,379
18/3/2021,Pulau Pinang,1292,248,1249,0,12,12,0,9,9,111,0,752
18/3/2021,Sabah,2948,817,2823,11,15,26,6,15,21,131,36,1567
18/3/2021,Sarawak,3054,870,2967,56,207,263,56,160,216,306,81,1674
18/3/2021,Selangor,4742,1212,4532,165,98,263,143,89,232,327,352,2515
18/3/2021,Terengganu,1231,212,1211,3,1,4,7,9,16,46,15,783
18/3/2021,W.P. Kuala Lumpur,3997,316,3930,1,10,11,0,8,8,50,40,1997
18/3/2021,W.P. Labuan,122,25,112,0,0,0,0,0,0,1,2,67
19/3/2021,Johor,4550,952,4432,114,28,142,75,49,124,344,157,2950
19/3/2021,Kedah,1844,215,1783,2,13,15,2,8,10,96,4,1345
19/3/2021,Kelantan,2497,296,2373,0,16,16,1,9,10,137,0,1310
19/3/2021,Melaka,1101,125,1048,6,4,10,0,7,7,16,7,860
19/3/2021,Negeri Sembilan,1251,503,1204,0,8,8,0,8,8,55,0,748
19/3/2021,Pahang,2170,701,2113,2,13,15,1,2,3,25,42,1329
19/3/2021,Perak,2728,359,2656,1,4,5,1,5,6,55,5,1815
19/3/2021,Perlis,508,57,493,0,0,0,0,0,0,13,6,367
19/3/2021,Pulau Pinang,1292,248,1249,0,8,8,0,16,16,112,0,748
19/3/2021,Sabah,2948,817,2823,9,15,24,7,23,30,127,36,1551
19/3/2021,Sarawak,3054,870,2967,50,154,204,41,165,206,325,95,1518
19/3/2021,Selangor,4742,1212,4532,212,96,308,152,90,242,335,299,2559
19/3/2021,Terengganu,1231,212,1211,2,9,11,5,2,7,53,12,792
19/3/2021,W.P. Kuala Lumpur,3997,316,3930,1,6,7,0,8,8,43,50,1960
19/3/2021,W.P. Labuan,122,25,112,0,0,0,1,1,2,0,1,62
20/3/2021,Johor,4550,952,4432,100,38,138,62,30,92,356,128,2452
20/3/2021,Kedah,1844,215,1783,0,11,11,0,4,4,105,2,1359
20/3/2021,Kelantan,2407,281,2283,1,19,20,0,28,28,129,1,1194
20/3/2021,Melaka,1101,125,1048,2,2,4,0,4,4,14,9,824
20/3/2021,Negeri Sembilan,1251,503,1204,0,9,9,0,5,5,59,0,709
20/3/2021,Pahang,2170,701,2113,3,14,17,0,0,0,39,44,1256
20/3/2021,Perak,2728,359,2656,0,9,9,0,8,8,55,6,1719
20/3/2021,Perlis,508,57,493,1,0,1,1,8,9,6,7,348
20/3/2021,Pulau Pinang,1292,248,1249,0,13,13,0,17,17,109,0,694
20/3/2021,Sabah,2948,817,2815,8,7,15,12,19,31,121,34,1487
20/3/2021,Sarawak,3054,870,2967,65,199,264,52,169,221,335,92,1566
20/3/2021,Selangor,4742,1212,4532,179,76,255,112,91,203,321,375,2373
20/3/2021,Terengganu,1231,212,1211,0,2,2,1,0,1,55,11,767
20/3/2021,W.P. Kuala Lumpur,3997,316,3930,3,8,11,2,1,3,49,49,1825
20/3/2021,W.P. Labuan,122,25,112,2,1,3,0,0,0,1,3,53
21/3/2021,Johor,4550,952,4432,106,36,142,64,22,86,367,142,3034
21/3/2021,Kedah,1844,215,1783,6,24,30,1,7,8,117,7,1364
21/3/2021,Kelantan,2407,281,2283,1,32,33,1,4,5,156,0,1313
21/3/2021,Melaka,1101,125,1048,1,1,2,3,1,4,19,7,824
21/3/2021,Negeri Sembilan,1251,503,1204,0,6,6,0,2,2,64,1,684
21/3/2021,Pahang,2170,701,2113,0,2,2,1,9,10,31,43,1233
21/3/2021,Perak,2728,359,2656,0,3,3,1,9,10,49,6,1697
21/3/2021,Perlis,508,57,493,1,0,1,4,3,7,3,4,286
21/3/2021,Pulau Pinang,1292,248,1249,0,14,14,0,23,23,92,0,646
21/3/2021,Sabah,2948,817,2815,6,17,23,5,14,19,124,35,1426
21/3/2021,Sarawak,3054,870,2967,54,119,173,53,112,165,329,86,1502
21/3/2021,Selangor,4742,1212,4532,152,77,229,101,71,172,336,301,2502
21/3/2021,Terengganu,1231,212,1211,5,10,15,2,4,6,61,10,786
21/3/2021,W.P. Kuala Lumpur,3997,316,3930,3,4,7,0,5,5,48,50,1856
21/3/2021,W.P. Labuan,122,25,112,1,0,1,0,0,0,1,4,53
22/3/2021,Johor,4550,952,4432,108,29,137,66,44,110,355,149,3030
22/3/2021,Kedah,1844,215,1783,4,17,21,0,9,9,128,8,1430
22/3/2021,Kelantan,2407,281,2283,0,38,38,1,30,31,164,0,1378
22/3/2021,Melaka,1101,125,1048,0,1,1,0,1,1,20,6,853
22/3/2021,Negeri Sembilan,1251,503,1204,3,12,15,0,8,8,68,4,705
22/3/2021,Pahang,2170,701,2113,4,10,14,2,0,2,40,45,1272
22/3/2021,Perak,2728,359,2656,1,6,7,1,6,7,50,7,1766
22/3/2021,Perlis,508,57,493,0,1,1,2,1,3,3,2,291
22/3/2021,Pulau Pinang,1292,248,1249,0,15,15,0,20,20,90,0,687
22/3/2021,Sabah,2948,705,2815,1,17,18,7,6,13,126,30,1507
22/3/2021,Sarawak,3054,870,2959,96,203,299,71,187,258,347,100,1468
22/3/2021,Selangor,4742,1212,4532,151,73,224,122,76,198,340,308,2553
22/3/2021,Terengganu,1231,212,1211,6,8,14,4,7,11,62,16,800
22/3/2021,W.P. Kuala Lumpur,3997,316,3930,4,4,8,2,8,10,50,59,1884
22/3/2021,W.P. Labuan,122,25,112,0,0,0,1,0,1,1,3,52
23/3/2021,Johor,4550,952,4432,143,36,179,87,43,130,350,168,3009
23/3/2021,Kedah,1844,215,1783,3,17,20,0,19,19,127,6,1442
23/3/2021,Kelantan,2407,281,2283,2,17,19,0,17,17,164,2,1365
23/3/2021,Melaka,1101,125,1048,2,4,6,1,3,4,21,7,863
23/3/2021,Negeri Sembilan,1251,503,1204,4,5,9,2,5,7,69,6,745
23/3/2021,Pahang,2170,701,2113,1,11,12,16,8,24,43,30,1322
23/3/2021,Perak,2728,359,2656,1,6,7,0,3,3,52,8,1862
23/3/2021,Perlis,508,57,493,0,0,0,1,0,1,3,1,313
23/3/2021,Pulau Pinang,1292,248,1249,0,16,16,0,22,22,85,0,750
23/3/2021,Sabah,2948,705,2815,4,24,28,3,11,14,134,39,1542
23/3/2021,Sarawak,3054,870,2959,70,134,204,55,163,218,331,98,1532
23/3/2021,Selangor,4742,1212,4532,154,86,240,102,105,207,350,343,2556
23/3/2021,Terengganu,1231,212,1211,2,2,4,4,7,11,56,14,878
23/3/2021,W.P. Kuala Lumpur,3997,316,3930,2,8,10,7,7,14,51,49,2083
23/3/2021,W.P. Labuan,122,25,112,0,0,0,3,0,3,1,2,59
24/3/2021,Johor,4550,952,4432,95,33,128,102,22,124,364,133,3088
24/3/2021,Kedah,1844,215,1783,3,31,34,1,10,11,147,6,1462
24/3/2021,Kelantan,2407,281,2283,1,28,29,2,23,25,169,1,1345
24/3/2021,Melaka,1101,125,1048,1,9,10,1,3,4,28,8,892
24/3/2021,Negeri Sembilan,1251,503,1204,0,3,3,1,7,8,63,5,769
24/3/2021,Pahang,2170,701,2113,2,0,2,0,1,1,42,32,1313
24/3/2021,Perak,2728,359,2656,0,8,8,0,6,6,55,9,1870
24/3/2021,Perlis,508,57,493,1,0,1,1,1,2,3,1,339
24/3/2021,Pulau Pinang,1292,248,1249,1,23,24,0,10,10,99,1,763
24/3/2021,Sabah,2948,705,2815,12,15,27,5,8,13,136,38,1546
24/3/2021,Sarawak,3054,870,2959,76,121,197,43,97,140,338,96,1631
24/3/2021,Selangor,4742,1212,4532,132,76,208,102,66,168,359,415,2465
24/3/2021,Terengganu,1231,212,1211,2,2,4,2,11,13,47,14,912
24/3/2021,W.P. Kuala Lumpur,3997,316,3930,6,12,18,5,9,14,53,55,2011
24/3/2021,W.P. Labuan,122,25,112,0,0,0,0,0,0,1,2,66
25/3/2021,Johor,4550,952,4432,112,57,169,79,59,138,362,151,3093
25/3/2021,Kedah,1844,215,1783,2,11,13,1,8,9,152,6,1482
25/3/2021,Kelantan,2407,281,2283,0,26,26,0,28,28,167,1,1349
25/3/2021,Melaka,1101,125,1048,0,13,13,0,2,2,32,6,912
25/3/2021,Negeri Sembilan,1251,503,1204,0,16,16,0,9,9,71,1,782
25/3/2021,Pahang,2170,701,2113,2,6,8,16,6,22,42,17,1378
25/3/2021,Perak,2728,359,2656,0,5,5,1,15,16,45,7,1863
25/3/2021,Perlis,508,57,493,1,0,1,0,1,1,2,1,322
25/3/2021,Pulau Pinang,1292,248,1249,0,18,18,0,9,9,106,0,725
25/3/2021,Sabah,2948,595,2815,4,11,15,5,18,23,141,39,1536
25/3/2021,Sarawak,3054,870,2959,67,125,192,48,145,193,361,91,1601
25/3/2021,Selangor,4742,1227,4532,182,99,281,132,93,225,377,483,2419
25/3/2021,Terengganu,1231,212,1211,2,0,2,3,8,11,19,14,809
25/3/2021,W.P. Kuala Lumpur,3997,343,3930,7,5,12,8,4,12,55,62,1995
25/3/2021,W.P. Labuan,122,25,112,0,0,0,0,1,1,0,1,68
26/3/2021,Johor,4550,952,4432,108,40,148,114,37,151,354,174,2880
26/3/2021,Kedah,1844,215,1783,1,16,17,0,20,20,149,5,1379
26/3/2021,Kelantan,2407,281,2283,4,18,22,1,19,20,167,3,1202
26/3/2021,Melaka,1101,125,1048,0,5,5,3,7,10,30,3,915
26/3/2021,Negeri Sembilan,1251,503,1204,1,9,10,0,7,7,73,2,766
26/3/2021,Pahang,2170,701,2113,1,1,2,14,2,16,41,4,1313
26/3/2021,Perak,2728,359,2656,0,8,8,1,10,11,43,1,1831
26/3/2021,Perlis,508,57,493,1,1,2,1,1,2,2,1,305
26/3/2021,Pulau Pinang,1292,248,1249,0,21,21,0,8,8,117,0,740
26/3/2021,Sabah,2948,595,2815,13,22,35,6,20,26,140,46,1534
26/3/2021,Sarawak,3054,870,2959,69,163,232,33,201,234,329,93,1627
26/3/2021,Selangor,4742,1227,4532,189,94,283,98,104,202,366,422,2386
26/3/2021,Terengganu,1231,212,1211,4,3,7,2,3,5,37,16,860
26/3/2021,W.P. Kuala Lumpur,3997,343,3930,7,3,10,13,9,22,51,52,2019
26/3/2021,W.P. Labuan,122,25,112,2,0,2,0,0,0,0,3,63
27/3/2021,Johor,4550,952,4432,98,37,135,90,37,127,356,128,2919
27/3/2021,Kedah,1844,215,1783,3,10,13,1,11,12,145,6,1323
27/3/2021,Kelantan,2407,281,2283,0,29,29,3,26,29,164,1,1193
27/3/2021,Melaka,1101,125,1048,4,3,7,0,3,3,30,7,843
27/3/2021,Negeri Sembilan,1251,503,1204,0,4,4,1,6,7,69,1,668
27/3/2021,Pahang,2170,701,2113,0,2,2,1,5,6,38,3,1241
27/3/2021,Perak,2728,359,2656,0,8,8,0,4,4,47,1,1702
27/3/2021,Perlis,508,57,493,0,0,0,1,0,1,2,0,280
27/3/2021,Pulau Pinang,1292,248,1249,0,17,17,0,5,5,113,0,693
27/3/2021,Sabah,2948,595,2815,2,31,33,15,13,28,143,43,1494
27/3/2021,Sarawak,3054,870,2959,92,190,282,39,256,295,357,128,1563
27/3/2021,Selangor,4742,1227,4532,170,73,243,120,74,194,367,393,2417
27/3/2021,Terengganu,1231,212,1211,5,2,7,4,11,15,28,21,842
27/3/2021,W.P. Kuala Lumpur,3997,343,3930,6,6,12,4,5,9,50,56,1799
27/3/2021,W.P. Labuan,122,25,112,0,0,0,0,0,0,0,3,50
28/3/2021,Johor,4550,952,4432,106,37,143,78,38,116,355,137,2939
28/3/2021,Kedah,1844,215,1783,0,12,12,0,10,10,146,6,1401
28/3/2021,Kelantan,2407,281,2283,1,32,33,0,18,18,177,2,1279
28/3/2021,Melaka,1101,125,1048,1,2,3,0,0,0,32,8,828
28/3/2021,Negeri Sembilan,1251,503,1204,0,3,3,0,4,4,66,1,683
28/3/2021,Pahang,2170,701,2113,0,3,3,0,3,3,38,3,1242
28/3/2021,Perak,2728,359,2656,1,4,5,1,9,10,41,1,1656
28/3/2021,Perlis,508,57,493,2,0,2,0,0,0,2,2,265
28/3/2021,Pulau Pinang,1292,248,1249,0,24,24,0,15,15,132,0,647
28/3/2021,Sabah,2948,595,2815,12,8,20,2,5,7,151,42,1470
28/3/2021,Sarawak,3054,870,2955,75,204,279,60,172,232,365,98,1534
28/3/2021,Selangor,4742,1227,4532,122,61,183,112,77,189,358,401,2332
28/3/2021,Terengganu,1231,212,1211,2,3,5,12,0,12,31,11,920
28/3/2021,W.P. Kuala Lumpur,3997,343,3930,4,1,5,7,6,13,44,37,1778
28/3/2021,W.P. Labuan,122,25,112,0,0,0,0,0,0,0,3,56
29/3/2021,Johor,4550,952,4432,109,42,151,68,33,101,365,132,3008
29/3/2021,Kedah,1844,215,1783,1,13,14,0,20,20,136,7,1455
29/3/2021,Kelantan,2407,294,2283,0,21,21,2,33,35,164,0,1351
29/3/2021,Melaka,1101,125,1048,0,1,1,0,2,2,31,8,818
29/3/2021,Negeri Sembilan,1251,503,1204,1,4,5,1,5,6,65,1,740
29/3/2021,Pahang,2170,701,2113,0,17,17,0,7,7,48,2,1227
29/3/2021,Perak,2728,359,2656,0,4,4,0,8,8,37,0,1719
29/3/2021,Perlis,508,57,493,0,0,0,0,0,0,2,2,283
29/3/2021,Pulau Pinang,1292,248,1249,0,20,20,0,18,18,122,0,659
29/3/2021,Sabah,2948,595,2815,17,16,33,13,13,26,140,47,1503
29/3/2021,Sarawak,3054,870,2955,61,158,219,51,189,240,357,104,1590
29/3/2021,Selangor,4742,1227,4532,136,53,189,104,78,182,334,418,2465
29/3/2021,Terengganu,1231,212,1211,2,2,4,4,8,12,25,10,895
29/3/2021,W.P. Kuala Lumpur,3997,343,3930,2,1,3,1,3,4,43,35,1922
29/3/2021,W.P. Labuan,122,25,112,0,0,0,1,0,1,0,2,62
30/3/2021,Johor,4550,952,4432,113,41,154,74,37,111,372,166,3085
30/3/2021,Kedah,1844,215,1783,4,9,13,1,27,28,121,10,1449
30/3/2021,Kelantan,2551,304,2422,0,20,20,0,18,18,166,0,1366
30/3/2021,Melaka,1101,125,1048,0,1,1,0,3,3,29,8,814
30/3/2021,Negeri Sembilan,1251,503,1204,0,1,1,2,6,8,57,2,761
30/3/2021,Pahang,2170,701,2113,1,7,8,1,18,19,37,2,1284
30/3/2021,Perak,2728,359,2656,1,4,5,0,2,2,31,0,1436
30/3/2021,Perlis,508,57,493,1,1,2,0,0,0,3,3,287
30/3/2021,Pulau Pinang,1292,248,1249,0,6,6,0,23,23,109,0,724
30/3/2021,Sabah,2948,645,2815,10,26,36,11,23,34,141,46,1587
30/3/2021,Sarawak,3054,929,2943,66,151,217,36,164,200,352,109,1619
30/3/2021,Selangor,4742,1227,4532,142,58,200,125,78,203,315,399,2565
30/3/2021,Terengganu,1231,212,1211,0,2,2,3,8,11,19,8,916
30/3/2021,W.P. Kuala Lumpur,3997,343,3930,2,1,3,5,6,11,39,30,1982
30/3/2021,W.P. Labuan,122,25,112,0,0,0,0,0,0,0,2,58
31/3/2021,Johor,4550,952,4432,141,42,183,88,34,122,380,162,3071
31/3/2021,Kedah,1844,215,1783,0,9,9,3,17,20,110,9,1430
31/3/2021,Kelantan,2407,294,2283,0,22,22,0,20,20,170,0,1344
31/3/2021,Melaka,1101,125,1048,2,4,6,0,4,4,29,10,843
31/3/2021,Negeri Sembilan,1251,503,1204,0,5,5,1,7,8,56,1,786
31/3/2021,Pahang,2170,701,2113,2,9,11,1,3,4,43,3,1323
31/3/2021,Perak,2728,359,2656,0,12,12,0,3,3,48,0,1845
31/3/2021,Perlis,508,57,493,2,1,3,0,1,1,3,5,288
31/3/2021,Pulau Pinang,1292,248,1249,0,7,7,0,11,11,84,0,797
31/3/2021,Sabah,2948,645,2815,10,35,45,11,5,16,173,44,1543
31/3/2021,Sarawak,3054,924,2943,102,141,243,45,114,159,356,129,1632
31/3/2021,Selangor,4742,1227,4532,125,68,193,101,67,168,339,465,2502
31/3/2021,Terengganu,1231,212,1211,3,2,5,1,2,3,18,10,870
31/3/2021,W.P. Kuala Lumpur,3997,288,3930,5,4,9,2,3,5,44,31,2005
31/3/2021,W.P. Labuan,122,25,112,0,0,0,0,0,0,0,2,60
1/4/2021,Johor,4550,952,4432,150,37,187,94,51,145,369,159,3047
1/4/2021,Kedah,1844,215,1783,1,2,3,3,28,31,91,3,1415
1/4/2021,Kelantan,2407,294,2283,2,25,27,0,30,30,165,2,1340
1/4/2021,Melaka,1101,125,1048,0,7,7,3,10,13,26,7,857
1/4/2021,Negeri Sembilan,1251,503,1204,2,7,9,0,5,5,59,2,801
1/4/2021,Pahang,2170,701,2113,2,8,10,2,1,3,44,2,1327
1/4/2021,Perak,2728,359,2656,0,7,7,0,3,3,51,1,1867
1/4/2021,Perlis,508,57,493,0,0,0,0,1,1,2,5,279
1/4/2021,Pulau Pinang,1292,248,1249,0,18,18,0,17,17,95,0,748
1/4/2021,Sabah,2948,645,2815,8,34,42,17,21,38,145,34,1573
1/4/2021,Sarawak,3054,924,2943,68,124,192,52,179,231,365,117,1618
1/4/2021,Selangor,4742,1227,4532,112,69,181,115,87,202,309,486,2438
1/4/2021,Terengganu,1231,212,1211,2,2,4,1,0,1,20,11,812
1/4/2021,W.P. Kuala Lumpur,3997,288,3930,7,11,18,6,2,8,53,31,2006
1/4/2021,W.P. Labuan,122,25,112,6,0,6,0,0,0,0,8,68
2/4/2021,Johor,4550,952,4432,126,45,171,79,35,114,383,162,2976
2/4/2021,Kedah,1844,215,1783,1,9,10,0,17,17,81,4,1291
2/4/2021,Kelantan,2407,294,2283,3,21,24,2,16,18,165,3,821
2/4/2021,Melaka,1101,125,1048,0,3,3,1,6,7,23,6,872
2/4/2021,Negeri Sembilan,1251,503,1204,0,7,7,0,8,8,58,2,744
2/4/2021,Pahang,2170,701,2113,1,2,3,1,5,6,44,2,1282
2/4/2021,Perak,2728,359,2656,0,9,9,0,8,8,50,1,1816
2/4/2021,Perlis,508,57,493,2,0,2,1,0,1,2,6,269
2/4/2021,Pulau Pinang,1292,248,1249,0,15,15,0,17,17,91,0,743
2/4/2021,Sabah,2948,645,2815,11,26,37,6,7,13,160,36,1578
2/4/2021,Sarawak,3054,924,2943,65,196,261,64,178,242,378,112,1565
2/4/2021,Selangor,4742,1227,4532,196,68,264,146,69,215,307,439,2509
2/4/2021,Terengganu,1231,212,1211,1,1,2,2,4,6,17,10,809
2/4/2021,W.P. Kuala Lumpur,3997,288,3930,4,4,8,4,5,9,52,29,2032
2/4/2021,W.P. Labuan,122,25,112,1,1,2,0,0,0,1,9,57
3/4/2021,Johor,4550,952,4432,105,38,143,85,39,124,382,145,3044
3/4/2021,Kedah,1844,215,1783,2,8,10,0,8,8,84,5,1293
3/4/2021,Kelantan,2407,294,2283,2,29,31,2,28,30,162,2,1203
3/4/2021,Melaka,1101,125,1048,0,9,9,3,4,7,28,3,813
3/4/2021,Negeri Sembilan,1251,503,1204,0,14,14,0,6,6,65,2,723
3/4/2021,Pahang,2170,701,2113,4,12,16,1,6,7,50,5,1203
3/4/2021,Perak,2728,359,2656,0,2,2,0,5,5,47,0,1722
3/4/2021,Perlis,508,57,493,4,0,4,1,0,1,2,8,264
3/4/2021,Pulau Pinang,1292,248,1249,0,14,14,0,11,11,83,0,690
3/4/2021,Sabah,2948,645,2815,9,23,32,11,10,21,177,37,1514
3/4/2021,Sarawak,3054,924,2943,108,196,304,44,187,231,363,122,1555
3/4/2021,Selangor,4742,1227,4532,105,66,171,95,60,155,326,322,2483
3/4/2021,Terengganu,1231,212,1211,5,8,13,3,1,4,24,12,780
3/4/2021,W.P. Kuala Lumpur,3997,288,3930,10,1,11,5,8,13,43,30,1865
3/4/2021,W.P. Labuan,122,25,112,0,0,0,0,0,0,1,9,47
4/4/2021,Johor,4550,952,4432,102,27,129,72,38,110,373,147,3097
4/4/2021,Kedah,1844,215,1783,3,1,4,0,15,15,69,6,1359
4/4/2021,Kelantan,2407,294,2283,0,18,18,1,28,29,150,2,1297
4/4/2021,Melaka,1101,125,1048,1,3,4,1,1,2,30,3,803
4/4/2021,Negeri Sembilan,1251,503,1204,3,2,5,0,5,5,63,3,716
4/4/2021,Pahang,2170,701,2113,1,5,6,0,18,18,36,5,1222
4/4/2021,Perak,2728,359,2656,1,7,8,0,12,12,41,1,1701
4/4/2021,Perlis,508,57,493,1,1,2,1,0,1,3,6,259
4/4/2021,Pulau Pinang,1292,248,1249,0,15,15,0,21,21,81,0,671
4/4/2021,Sabah,2948,645,2815,7,31,38,9,14,23,172,31,1487
4/4/2021,Sarawak,3054,924,2943,91,205,296,61,189,250,332,111,1584
4/4/2021,Selangor,4742,1227,4532,123,96,219,77,75,152,332,355,2398
4/4/2021,Terengganu,1231,212,1211,0,2,2,2,2,4,24,10,823
4/4/2021,W.P. Kuala Lumpur,3997,288,3930,2,3,5,1,10,11,46,25,1872
4/4/2021,W.P. Labuan,122,25,112,0,0,0,0,0,0,1,6,49
5/4/2021,Johor,4550,952,4432,139,38,177,70,30,100,385,189,3069
5/4/2021,Kedah,1844,215,1783,1,11,12,0,8,8,76,3,1382
5/4/2021,Kelantan,2407,294,2283,2,16,18,1,21,22,143,3,1365
5/4/2021,Melaka,1101,125,1048,0,2,2,0,2,2,30,3,851
5/4/2021,Negeri Sembilan,1251,503,1204,0,8,8,1,7,8,61,3,745
5/4/2021,Pahang,2170,701,2113,0,3,3,4,5,9,39,0,1137
5/4/2021,Perak,2728,359,2656,0,1,1,0,3,3,36,1,1800
5/4/2021,Perlis,508,57,493,0,0,0,0,0,0,3,7,277
5/4/2021,Pulau Pinang,1292,248,1249,0,21,21,0,16,16,83,0,672
5/4/2021,Sabah,2948,645,2815,7,40,47,11,9,20,188,27,1613
5/4/2021,Sarawak,3054,924,2943,166,190,356,38,203,241,349,112,1565
5/4/2021,Selangor,4742,1227,4532,146,70,216,97,69,166,346,377,2401
5/4/2021,Terengganu,1231,212,1211,1,4,5,1,5,6,23,10,930
5/4/2021,W.P. Kuala Lumpur,3997,288,3930,6,1,7,0,5,5,43,21,2018
5/4/2021,W.P. Labuan,122,25,112,0,2,2,0,0,0,3,3,49
6/4/2021,Johor,4550,952,4432,134,39,173,83,53,136,369,183,3145
6/4/2021,Kedah,1844,215,1783,1,4,5,0,13,13,67,4,1408
6/4/2021,Kelantan,2407,294,2283,0,23,23,1,16,17,150,2,1376
6/4/2021,Melaka,1101,125,1048,0,9,9,1,7,8,34,2,836
6/4/2021,Negeri Sembilan,1251,503,1204,0,4,4,1,8,9,56,2,771
6/4/2021,Pahang,2170,701,2113,3,9,12,0,1,1,47,3,1190
6/4/2021,Perak,2728,359,2656,2,7,9,0,1,1,42,2,1843
6/4/2021,Perlis,508,57,493,4,0,4,0,0,0,3,11,306
6/4/2021,Pulau Pinang,1292,248,1249,0,7,7,0,7,7,87,0,754
6/4/2021,Sabah,2948,645,2815,11,55,66,6,16,22,202,26,1672
6/4/2021,Sarawak,3054,924,2943,89,211,300,65,193,258,354,119,1594
6/4/2021,Selangor,4742,1227,4532,138,83,221,132,59,191,375,337,2555
6/4/2021,Terengganu,1231,212,1211,4,3,7,2,0,2,26,12,938
6/4/2021,W.P. Kuala Lumpur,3997,288,3930,5,4,9,4,2,6,47,28,2040
6/4/2021,W.P. Labuan,122,25,112,0,2,2,0,0,0,5,2,55
7/4/2021,Johor,4550,952,4432,116,51,167,92,46,138,376,158,3156
7/4/2021,Kedah,1844,215,1783,2,6,8,0,14,14,61,5,1441
7/4/2021,Kelantan,2407,294,2283,2,47,49,2,20,22,178,2,1385
7/4/2021,Melaka,1101,125,1048,1,0,1,0,3,3,30,3,860
7/4/2021,Negeri Sembilan,1251,503,1204,2,4,6,2,6,8,54,1,779
7/4/2021,Pahang,2170,701,2113,3,2,5,0,2,2,38,6,1207
7/4/2021,Perak,2728,359,2656,0,4,4,0,4,4,42,4,1932
7/4/2021,Perlis,508,57,493,1,0,1,5,0,5,3,7,308
7/4/2021,Pulau Pinang,1292,248,1249,0,13,13,0,12,12,92,0,750
7/4/2021,Sabah,2948,645,2815,6,28,34,4,14,18,201,26,1648
7/4/2021,Sarawak,3054,924,2943,118,203,321,54,124,178,353,138,1652
7/4/2021,Selangor,4742,1227,4532,170,75,245,133,72,205,383,351,2544
7/4/2021,Terengganu,1231,212,1211,7,2,9,6,2,8,26,14,893
7/4/2021,W.P. Kuala Lumpur,3997,288,3930,6,6,12,4,3,7,53,29,2042
7/4/2021,W.P. Labuan,122,25,112,0,1,1,0,0,0,6,2,47
8/4/2021,Johor,4550,952,4432,90,38,128,70,47,117,358,148,2241
8/4/2021,Kedah,1844,215,1783,0,8,8,0,16,16,62,1,1439
8/4/2021,Kelantan,2407,294,2283,0,15,15,2,25,27,158,0,1323
8/4/2021,Melaka,1101,125,1048,0,4,4,0,3,3,31,3,832
8/4/2021,Negeri Sembilan,1251,503,1204,1,6,7,1,9,10,50,1,783
8/4/2021,Pahang,2170,701,2113,1,12,13,1,9,10,40,6,1207
8/4/2021,Perak,2728,359,2656,0,0,0,0,0,0,0,0,47
8/4/2021,Perlis,508,57,493,1,1,2,3,1,4,3,5,296
8/4/2021,Pulau Pinang,1292,248,1249,0,21,21,0,16,16,95,0,751
8/4/2021,Sabah,2948,645,2815,14,55,69,9,14,23,214,26,1652
8/4/2021,Sarawak,3054,924,2943,86,231,317,54,161,215,377,129,1632
8/4/2021,Selangor,4742,1227,4532,137,95,232,122,107,229,383,329,2584
8/4/2021,Terengganu,1231,212,1211,2,1,3,2,2,4,25,15,767
8/4/2021,W.P. Kuala Lumpur,3997,277,3930,5,11,16,6,9,15,48,28,2099
8/4/2021,W.P. Labuan,122,25,112,2,2,4,2,0,2,8,2,53
9/4/2021,Johor,4550,952,4432,118,45,163,49,88,137,354,164,3089
9/4/2021,Kedah,1844,215,1783,2,14,16,1,9,10,66,2,1443
9/4/2021,Kelantan,2407,294,2283,1,39,40,0,20,20,173,1,1186
9/4/2021,Melaka,1101,125,1048,2,3,5,2,5,7,29,3,849
9/4/2021,Negeri Sembilan,1251,503,1204,1,7,8,0,5,5,51,2,742
9/4/2021,Pahang,2170,701,2113,0,4,4,0,8,8,36,6,1198
9/4/2021,Perak,2728,359,2656,1,4,5,1,6,7,38,2,1895
9/4/2021,Perlis,508,57,493,0,0,0,1,0,1,3,4,304
9/4/2021,Pulau Pinang,1292,248,1249,0,32,32,0,10,10,115,0,816
9/4/2021,Sabah,2948,645,2815,7,54,61,8,13,21,249,27,1644
9/4/2021,Sarawak,3054,924,2943,75,193,268,61,241,302,370,149,1688
9/4/2021,Selangor,4742,1227,4532,128,62,190,112,66,178,383,346,2560
9/4/2021,Terengganu,1231,212,1211,3,1,4,0,3,3,23,19,784
9/4/2021,W.P. Kuala Lumpur,3997,277,3930,5,5,10,4,2,6,51,31,2130
9/4/2021,W.P. Labuan,122,25,112,0,1,1,0,0,0,9,1,56
10/4/2021,Johor,4550,952,4432,125,41,166,84,45,129,376,174,3054
10/4/2021,Kedah,1844,215,1783,0,14,14,0,5,5,76,1,1424
10/4/2021,Kelantan,2407,294,2283,2,43,45,1,27,28,189,2,1162
10/4/2021,Melaka,1101,125,1048,0,3,3,0,6,6,26,3,850
10/4/2021,Negeri Sembilan,1251,503,1204,0,9,9,1,4,5,55,1,705
10/4/2021,Pahang,2170,701,2113,0,3,3,0,23,23,22,2,1132
10/4/2021,Perak,2728,359,2656,0,9,9,0,8,8,39,3,1809
10/4/2021,Perlis,508,57,493,1,2,3,3,0,3,5,2,287
10/4/2021,Pulau Pinang,1292,248,1249,0,14,14,0,7,7,114,0,726
10/4/2021,Sabah,2948,645,2815,8,59,67,6,18,24,249,26,1599
10/4/2021,Sarawak,3054,924,2943,121,313,434,60,194,254,381,132,1562
10/4/2021,Selangor,4742,1227,4532,139,107,246,98,115,213,381,311,2497
10/4/2021,Terengganu,1231,212,1211,8,10,18,4,1,5,32,22,762
10/4/2021,W.P. Kuala Lumpur,3997,277,3930,3,3,6,5,9,14,43,24,1998
10/4/2021,W.P. Labuan,122,25,112,0,0,0,0,5,5,4,1,60
11/4/2021,Johor,4550,952,4432,121,29,150,68,41,109,365,151,3090
11/4/2021,Kedah,1844,215,1783,3,17,20,0,7,7,88,3,1498
11/4/2021,Kelantan,2407,294,2283,0,42,42,2,34,36,196,0,1258
11/4/2021,Melaka,1101,125,1048,2,1,3,1,1,2,26,4,748
11/4/2021,Negeri Sembilan,1251,503,1204,0,16,16,0,5,5,67,1,724
11/4/2021,Pahang,2170,701,2113,1,5,6,0,4,4,39,3,1292
11/4/2021,Perak,2728,359,2656,1,16,17,0,4,4,51,4,1759
11/4/2021,Perlis,508,57,493,4,0,4,0,2,2,3,6,282
11/4/2021,Pulau Pinang,1292,248,1249,0,14,14,0,14,14,107,0,665
11/4/2021,Sabah,2948,645,2815,9,43,52,6,10,16,251,29,1550
11/4/2021,Sarawak,3054,924,2943,69,269,338,42,302,344,399,125,1549
11/4/2021,Selangor,4742,1227,4532,125,57,182,112,60,172,381,353,2472
11/4/2021,Terengganu,1231,212,1211,6,8,14,1,6,7,35,31,800
11/4/2021,W.P. Kuala Lumpur,3997,277,3930,5,7,12,5,2,7,45,34,1880
11/4/2021,W.P. Labuan,122,25,112,0,0,0,0,1,1,3,1,55
12/4/2021,Johor,4550,952,4432,92,37,129,79,40,119,366,169,3053
12/4/2021,Kedah,1844,215,1783,3,5,8,0,6,6,87,6,1478
12/4/2021,Kelantan,2531,284,2402,1,33,34,0,25,25,206,1,1450
12/4/2021,Melaka,1101,125,1048,0,4,4,2,3,5,27,2,800
12/4/2021,Negeri Sembilan,1251,503,1204,0,8,8,0,2,2,70,0,770
12/4/2021,Pahang,2170,701,2113,0,12,12,0,4,4,47,3,1137
12/4/2021,Perak,2728,359,2656,0,1,1,0,5,5,47,6,1823
12/4/2021,Perlis,508,57,493,1,0,1,1,0,1,4,6,280
12/4/2021,Pulau Pinang,1292,248,1249,1,9,10,0,15,15,98,2,688
12/4/2021,Sabah,2948,690,2815,7,53,60,5,14,19,260,34,1557
12/4/2021,Sarawak,3054,924,2943,99,221,320,79,162,241,424,156,1544
12/4/2021,Selangor,4742,1227,4532,125,64,189,56,78,134,374,347,2573
12/4/2021,Terengganu,1231,212,1211,5,14,19,2,4,6,48,29,856
12/4/2021,W.P. Kuala Lumpur,3997,277,3930,3,3,6,5,4,9,48,31,1988
12/4/2021,W.P. Labuan,122,25,112,0,0,0,0,0,0,4,0,56
13/4/2021,Johor,4550,952,4432,104,19,123,67,38,105,349,172,3065
13/4/2021,Kedah,1844,215,1783,3,12,15,0,15,15,88,6,1427
13/4/2021,Kelantan,2531,284,2402,1,33,34,1,26,27,212,1,1452
13/4/2021,Melaka,1101,125,1048,0,0,0,0,6,6,21,2,827
13/4/2021,Negeri Sembilan,1251,503,1204,2,41,43,0,9,9,93,2,780
13/4/2021,Pahang,2170,701,2113,0,7,7,0,7,7,47,3,1173
13/4/2021,Perak,2728,359,2656,1,11,12,0,2,2,56,5,1851
13/4/2021,Perlis,508,57,493,0,1,1,1,0,1,5,3,284
13/4/2021,Pulau Pinang,1292,248,1249,0,10,10,0,18,18,107,0,745
13/4/2021,Sabah,2948,690,2815,9,49,58,7,25,32,281,35,1604
13/4/2021,Sarawak,3054,924,2943,96,226,322,46,310,356,449,156,1546
13/4/2021,Selangor,4742,1227,4532,162,78,240,83,90,173,368,407,2488
13/4/2021,Terengganu,1231,212,1211,2,1,3,5,6,11,43,26,853
13/4/2021,W.P. Kuala Lumpur,3997,277,3930,2,7,9,4,1,5,53,29,2052
13/4/2021,W.P. Labuan,122,25,112,3,0,3,0,0,0,4,3,67
14/4/2021,Johor,4550,952,4432,80,26,106,76,44,120,323,164,3175
14/4/2021,Kedah,1844,215,1783,1,6,7,0,7,7,86,4,1450
14/4/2021,Kelantan,2558,311,2429,2,55,57,1,43,44,220,2,1414
14/4/2021,Melaka,1101,125,1048,3,3,6,0,1,1,23,5,814
14/4/2021,Negeri Sembilan,1251,503,1204,0,57,57,0,9,9,142,2,768
14/4/2021,Pahang,2170,701,2113,1,4,5,1,3,4,46,3,1234
14/4/2021,Perak,2728,359,2656,0,12,12,0,7,7,61,8,1913
14/4/2021,Perlis,508,57,493,2,1,3,0,0,0,6,5,299
14/4/2021,Pulau Pinang,1292,248,1249,0,27,27,0,17,17,118,0,763
14/4/2021,Sabah,2948,690,2815,7,48,55,4,16,20,290,38,1620
14/4/2021,Sarawak,3054,924,2943,131,351,482,52,207,259,443,152,1489
14/4/2021,Selangor,4742,1227,4532,84,164,248,44,148,192,370,399,2663
14/4/2021,Terengganu,1231,212,1211,3,23,26,3,1,4,43,29,875
14/4/2021,W.P. Kuala Lumpur,3997,277,3930,1,5,6,7,6,13,46,24,2125
14/4/2021,W.P. Labuan,122,25,112,0,0,0,1,0,1,4,2,61
15/4/2021,Johor,4550,952,4432,107,44,151,79,38,117,328,170,3177
15/4/2021,Kedah,1844,215,1783,1,10,11,0,9,9,75,2,1417
15/4/2021,Kelantan,2558,329,2429,0,52,52,0,28,28,245,0,1421
15/4/2021,Melaka,1101,125,1048,1,2,3,0,3,3,22,6,817
15/4/2021,Negeri Sembilan,1251,503,1204,3,8,11,0,5,5,140,5,733
15/4/2021,Pahang,2170,701,2113,4,6,10,4,10,14,39,3,1220
15/4/2021,Perak,2728,359,2656,1,10,11,1,6,7,60,6,1913
15/4/2021,Perlis,508,57,493,4,3,7,1,0,1,9,6,294
15/4/2021,Pulau Pinang,1292,248,1249,0,17,17,0,17,17,117,0,745
15/4/2021,Sabah,2948,566,2815,14,36,50,10,6,16,237,44,1698
15/4/2021,Sarawak,3054,924,2943,110,514,624,39,208,247,510,153,1477
15/4/2021,Selangor,4742,1227,4532,166,93,259,131,99,230,368,364,2700
15/4/2021,Terengganu,1231,212,1211,1,2,3,2,1,3,44,28,869
15/4/2021,W.P. Kuala Lumpur,3997,242,3930,4,5,9,2,1,3,51,24,2085
15/4/2021,W.P. Labuan,122,25,112,0,0,0,1,0,1,4,1,59
16/4/2021,Johor,4550,952,4432,93,44,137,87,41,128,332,175,3056
16/4/2021,Kedah,1844,215,1783,4,5,9,0,9,9,82,4,1368
16/4/2021,Kelantan,2558,329,2429,3,58,61,0,40,40,253,3,1351
16/4/2021,Melaka,1101,125,1048,2,4,6,0,4,4,17,6,791
16/4/2021,Negeri Sembilan,1251,503,1204,0,35,35,1,10,11,171,4,753
16/4/2021,Pahang,2170,701,2113,2,12,14,0,1,1,50,3,1249
16/4/2021,Perak,2728,359,2656,0,9,9,0,2,2,67,6,1881
16/4/2021,Perlis,508,57,493,1,2,3,1,0,1,11,4,286
16/4/2021,Pulau Pinang,1292,248,1249,0,19,19,0,10,10,124,0,771
16/4/2021,Sabah,2948,566,2810,15,36,51,10,19,29,242,42,1691
16/4/2021,Sarawak,3054,924,2942,107,295,402,54,323,377,460,154,1560
16/4/2021,Selangor,4742,1227,4532,156,109,265,116,99,215,383,331,2628
16/4/2021,Terengganu,1231,212,1211,7,13,20,3,1,4,56,30,807
16/4/2021,W.P. Kuala Lumpur,3997,242,3930,1,5,6,2,2,4,53,20,1991
16/4/2021,W.P. Labuan,122,25,112,0,0,0,0,0,0,4,1,57
17/4/2021,Johor,4550,952,4432,76,44,120,84,33,117,351,155,3037
17/4/2021,Kedah,1844,215,1783,2,7,9,0,9,9,87,7,1378
17/4/2021,Kelantan,2566,311,2437,1,42,43,0,27,27,273,4,1291
17/4/2021,Melaka,1101,125,1048,2,4,6,0,4,4,17,6,795
17/4/2021,Negeri Sembilan,1251,503,1204,2,13,15,2,7,9,176,4,701
17/4/2021,Pahang,2170,701,2113,0,2,2,0,12,12,47,4,1141
17/4/2021,Perak,2728,359,2656,0,16,16,1,11,12,56,6,1721
17/4/2021,Perlis,508,57,493,5,0,5,1,0,1,11,9,255
17/4/2021,Pulau Pinang,1292,248,1249,0,24,24,0,12,12,128,0,688
17/4/2021,Sabah,2948,566,2810,15,25,40,7,13,20,235,52,1582
17/4/2021,Sarawak,3054,894,2934,140,373,513,64,345,409,511,158,1391
17/4/2021,Selangor,4742,1227,4532,175,101,276,87,113,200,378,331,1684
17/4/2021,Terengganu,1307,288,1287,7,22,29,3,0,3,78,34,792
17/4/2021,W.P. Kuala Lumpur,3997,242,3930,1,5,6,4,5,9,47,11,2050
17/4/2021,W.P. Labuan,122,25,112,0,0,0,0,1,1,3,1,57
18/4/2021,Johor,4550,952,4432,106,51,157,69,34,103,363,154,3090
18/4/2021,Kedah,1844,215,1783,1,16,17,0,7,7,85,6,1413
18/4/2021,Kelantan,2566,329,2437,2,44,46,2,38,40,266,4,1397
18/4/2021,Melaka,1101,125,1048,5,5,10,0,1,1,21,9,816
18/4/2021,Negeri Sembilan,1251,503,1204,0,50,50,0,17,17,209,4,721
18/4/2021,Pahang,2170,701,2113,3,3,6,0,2,2,51,3,1101
18/4/2021,Perak,2728,359,2656,0,5,5,1,6,7,54,5,1678
18/4/2021,Perlis,508,57,493,5,4,9,3,3,6,12,11,241
18/4/2021,Pulau Pinang,1292,248,1249,0,16,16,0,18,18,127,0,674
18/4/2021,Sabah,2948,566,2810,11,43,54,4,11,15,251,54,1571
18/4/2021,Sarawak,3054,894,2934,137,357,494,36,255,291,500,163,1526
18/4/2021,Selangor,4742,1227,4532,148,104,252,127,83,210,399,329,2589
18/4/2021,Terengganu,1307,288,1287,2,3,5,9,14,23,67,31,846
18/4/2021,W.P. Kuala Lumpur,3997,242,3930,4,4,8,1,3,4,48,25,2084
18/4/2021,W.P. Labuan,122,25,112,1,0,1,0,0,0,0,3,62
19/4/2021,Johor,4550,952,4432,113,50,163,56,45,101,366,174,3180
19/4/2021,Kedah,1844,215,1783,1,17,18,0,13,13,85,6,1434
19/4/2021,Kelantan,2686,336,2557,4,35,39,0,28,28,272,8,1513
19/4/2021,Melaka,1101,125,1048,0,4,4,3,4,7,21,6,841
19/4/2021,Negeri Sembilan,1251,503,1204,0,7,7,1,24,25,191,3,744
19/4/2021,Pahang,2170,701,2113,0,2,2,2,8,10,45,4,1150
19/4/2021,Perak,2728,359,2656,0,10,10,0,5,5,60,1,1791
19/4/2021,Perlis,508,57,493,6,1,7,2,1,3,10,9,254
19/4/2021,Pulau Pinang,1292,248,1249,0,36,36,0,10,10,148,0,717
19/4/2021,Sabah,2948,660,2810,7,31,38,18,19,37,254,44,1379
19/4/2021,Sarawak,3334,914,3211,105,299,404,62,314,376,504,174,1539
19/4/2021,Selangor,4742,1227,4532,139,103,242,128,71,199,426,375,2565
19/4/2021,Terengganu,1307,288,1287,1,2,3,3,7,10,62,33,859
19/4/2021,W.P. Kuala Lumpur,3997,242,3930,1,4,5,2,4,6,51,34,1947
19/4/2021,W.P. Labuan,122,25,112,0,2,2,0,0,0,6,1,64
20/4/2021,Johor,4550,952,4428,123,46,169,80,53,133,359,124,3291
20/4/2021,Kedah,1844,215,1783,4,13,17,1,9,10,84,8,1486
20/4/2021,Kelantan,2686,336,2557,6,55,61,6,53,59,274,8,1524
20/4/2021,Melaka,1101,125,1048,0,2,2,0,1,1,22,6,896
20/4/2021,Negeri Sembilan,1251,503,1204,1,12,13,2,44,46,159,2,821
20/4/2021,Pahang,2170,701,2113,2,6,8,4,3,7,38,2,1054
20/4/2021,Perak,2728,359,2656,0,9,9,1,5,6,63,5,1917
20/4/2021,Perlis,508,57,493,4,0,4,2,0,2,10,8,283
20/4/2021,Pulau Pinang,1292,248,1249,0,12,12,0,15,15,131,0,771
20/4/2021,Sabah,2948,660,2810,8,24,32,7,27,34,247,42,1656
20/4/2021,Sarawak,3334,914,3211,94,333,427,58,328,386,516,133,1545
20/4/2021,Selangor,4742,1227,4532,181,100,281,70,108,178,418,368,2718
20/4/2021,Terengganu,1307,288,1287,4,2,6,2,8,10,56,35,896
20/4/2021,W.P. Kuala Lumpur,3997,242,3930,6,6,12,9,4,13,52,34,2059
20/4/2021,W.P. Labuan,122,25,112,0,1,1,0,0,0,5,1,63
21/4/2021,Johor,4550,952,4428,124,54,178,73,54,127,364,139,3343
21/4/2021,Kedah,1844,215,1783,4,11,15,6,8,14,86,8,1461
21/4/2021,Kelantan,2686,336,2557,1,69,70,2,49,51,286,7,1465
21/4/2021,Melaka,1101,125,1048,0,3,3,2,3,5,22,4,928
21/4/2021,Negeri Sembilan,1251,503,1204,1,7,8,0,19,19,146,3,846
21/4/2021,Pahang,2170,701,2113,6,0,6,3,3,6,69,8,1260
21/4/2021,Perak,2728,359,2656,4,18,22,3,4,7,72,4,1949
21/4/2021,Perlis,508,57,493,1,1,2,4,0,4,11,3,278
21/4/2021,Pulau Pinang,1292,248,1249,0,14,14,0,19,19,127,0,779
21/4/2021,Sabah,2948,660,2810,12,41,53,9,21,30,262,39,1686
21/4/2021,Sarawak,3334,914,3211,97,319,416,29,353,382,525,156,1561
21/4/2021,Selangor,4742,1227,4532,145,142,287,103,106,209,465,384,2707
21/4/2021,Terengganu,1307,288,1287,1,1,2,0,10,10,47,36,939
21/4/2021,W.P. Kuala Lumpur,3997,254,3930,3,5,8,7,7,14,49,29,2091
21/4/2021,W.P. Labuan,122,25,112,0,0,0,0,0,0,5,1,71
22/4/2021,Johor,4550,952,4428,126,50,176,70,54,124,369,99,3291
22/4/2021,Kedah,1844,215,1783,4,11,15,2,9,11,91,6,1433
22/4/2021,Kelantan,2686,382,2557,5,84,89,3,79,82,287,9,1561
22/4/2021,Melaka,1101,125,1048,0,5,5,0,1,1,26,4,900
22/4/2021,Negeri Sembilan,1251,503,1204,1,45,46,2,18,20,171,2,810
22/4/2021,Pahang,2170,701,2113,2,12,14,2,11,13,52,4,1241
22/4/2021,Perak,2728,359,2656,0,15,15,0,11,11,78,5,1947
22/4/2021,Perlis,508,57,493,2,0,2,0,0,0,11,4,283
22/4/2021,Pulau Pinang,1292,248,1249,0,18,18,0,21,21,113,0,765
22/4/2021,Sabah,2948,660,2810,10,18,28,7,13,20,262,37,1711
22/4/2021,Sarawak,3334,914,3211,135,393,528,67,409,476,504,163,1601
22/4/2021,Selangor,4742,1227,4532,156,105,261,103,140,243,453,421,2580
22/4/2021,Terengganu,1307,288,1287,3,7,10,3,20,23,33,39,866
22/4/2021,W.P. Kuala Lumpur,3997,254,3930,3,16,19,7,4,11,65,26,1383
22/4/2021,W.P. Labuan,122,25,112,1,0,1,0,0,0,5,2,73
23/4/2021,Johor,4550,952,4428,128,73,201,77,36,113,404,139,3189
23/4/2021,Kedah,1844,215,1783,1,17,18,1,3,4,107,4,1351
23/4/2021,Kelantan,2686,382,2557,5,58,63,8,49,57,292,6,1378
23/4/2021,Melaka,1101,125,1048,0,23,23,3,8,11,41,1,904
23/4/2021,Negeri Sembilan,1251,503,1204,3,11,14,1,22,23,158,4,780
23/4/2021,Pahang,2170,701,2113,1,13,14,1,5,6,60,4,1258
23/4/2021,Perak,2728,270,2656,1,7,8,0,4,4,82,6,1916
23/4/2021,Perlis,508,57,493,2,0,2,0,0,0,10,5,310
23/4/2021,Pulau Pinang,1292,248,1249,0,20,20,0,11,11,121,0,761
23/4/2021,Sabah,2948,660,2810,18,22,40,15,26,41,255,43,1713
23/4/2021,Sarawak,3334,914,3211,102,387,489,47,385,432,518,189,1619
23/4/2021,Selangor,4742,1227,4532,160,136,296,111,116,227,472,432,2507
23/4/2021,Terengganu,1307,288,1287,2,2,4,3,6,9,29,39,863
23/4/2021,W.P. Kuala Lumpur,3997,254,3930,8,11,19,5,5,10,73,33,2050
23/4/2021,W.P. Labuan,122,25,112,0,0,0,0,0,0,5,2,77
24/4/2021,Johor,4550,952,4425,107,49,156,70,42,112,417,119,3167
24/4/2021,Kedah,1844,215,1783,3,16,19,2,11,13,117,5,1379
24/4/2021,Kelantan,2686,382,2557,3,55,58,3,31,34,316,6,1376
24/4/2021,Melaka,1101,125,1048,4,6,10,0,6,6,41,5,849
24/4/2021,Negeri Sembilan,1251,503,1204,2,19,21,0,13,13,163,6,710
24/4/2021,Pahang,2170,701,2113,4,2,6,4,3,7,32,30,1184
24/4/2021,Perak,2728,270,2655,1,10,11,0,5,5,84,4,1804
24/4/2021,Perlis,508,57,493,4,1,5,0,0,0,11,7,296
24/4/2021,Pulau Pinang,1292,248,1249,0,22,22,0,14,14,119,0,692
24/4/2021,Sabah,2948,660,2810,9,14,23,10,21,31,250,40,1306
24/4/2021,Sarawak,3334,914,3211,98,376,474,91,474,565,517,165,1546
24/4/2021,Selangor,4742,1227,4532,119,124,243,108,144,252,450,352,2530
24/4/2021,Terengganu,1307,288,1287,4,11,15,0,4,4,36,43,787
24/4/2021,W.P. Kuala Lumpur,3997,254,3930,6,12,18,6,7,13,70,33,1930
24/4/2021,W.P. Labuan,122,25,112,0,0,0,0,4,4,1,2,68
25/4/2021,Johor,4550,952,4425,219,57,276,50,48,98,428,96,3129
25/4/2021,Kedah,1844,215,1783,0,21,21,0,11,11,133,2,1358
25/4/2021,Kelantan,2686,402,2557,2,80,82,3,61,64,332,5,1380
25/4/2021,Melaka,1101,125,1048,0,7,7,2,5,7,43,3,824
25/4/2021,Negeri Sembilan,1251,503,1204,1,7,8,2,6,8,55,5,719
25/4/2021,Pahang,2170,701,2113,0,4,4,2,7,9,51,2,1126
25/4/2021,Perak,2728,270,2655,0,10,10,0,3,3,87,7,1714
25/4/2021,Perlis,508,57,493,1,0,1,1,0,1,11,7,277
25/4/2021,Pulau Pinang,1292,248,1249,0,25,25,0,23,23,124,0,667
25/4/2021,Sabah,2948,660,2810,13,25,38,6,20,26,249,49,1572
25/4/2021,Sarawak,3334,914,3211,89,277,366,89,545,634,543,127,1550
25/4/2021,Selangor,4742,1227,4532,156,134,290,136,138,274,452,404,2454
25/4/2021,Terengganu,1307,288,1287,4,12,16,3,5,8,43,43,874
25/4/2021,W.P. Kuala Lumpur,3997,254,3930,5,10,15,5,6,11,82,56,1907
25/4/2021,W.P. Labuan,122,25,112,0,0,0,0,0,0,1,2,65
26/4/2021,Johor,4550,983,4425,96,58,154,87,54,141,439,121,3112
26/4/2021,Kedah,1844,215,1783,3,8,11,1,14,15,124,3,1394
26/4/2021,Kelantan,2704,424,2575,5,78,83,1,48,49,356,7,1435
26/4/2021,Melaka,1101,125,1048,2,10,12,0,3,3,51,5,849
26/4/2021,Negeri Sembilan,1251,503,1204,4,22,26,3,21,24,135,6,764
26/4/2021,Pahang,2170,701,2113,1,10,11,1,7,8,54,2,793
26/4/2021,Perak,2728,270,2654,0,23,23,1,10,11,97,5,1737
26/4/2021,Perlis,508,57,493,2,1,3,4,0,4,12,6,287
26/4/2021,Pulau Pinang,1292,248,1249,0,17,17,0,16,16,126,0,722
26/4/2021,Sabah,2948,660,2810,15,18,33,19,16,35,220,42,1308
26/4/2021,Sarawak,3334,914,3190,109,444,553,97,411,508,526,123,1566
26/4/2021,Selangor,4742,1227,4532,125,120,245,115,85,200,491,399,2495
26/4/2021,Terengganu,1307,288,1287,8,3,11,9,8,17,38,44,837
26/4/2021,W.P. Kuala Lumpur,3997,254,3930,0,24,24,2,1,3,107,24,1857
26/4/2021,W.P. Labuan,122,25,112,0,0,0,0,0,0,1,2,67
27/4/2021,Johor,4550,983,4409,116,86,202,66,58,124,462,155,3099
27/4/2021,Kedah,1844,215,1783,1,19,20,0,14,14,125,1,1427
27/4/2021,Kelantan,2704,424,2575,4,64,68,4,54,58,364,7,1461
27/4/2021,Melaka,1101,125,1048,1,8,9,0,0,0,59,6,873
27/4/2021,Negeri Sembilan,1251,503,1204,2,18,20,3,20,23,125,5,800
27/4/2021,Pahang,2170,701,2113,1,5,6,0,7,7,51,3,1236
27/4/2021,Perak,2728,270,2654,0,13,13,1,14,15,93,3,1817
27/4/2021,Perlis,508,57,493,1,1,2,4,5,9,8,3,310
27/4/2021,Pulau Pinang,1292,248,1249,0,22,22,0,20,20,126,0,744
27/4/2021,Sabah,2948,660,2810,10,23,33,7,32,39,233,48,1643
27/4/2021,Sarawak,3334,914,3179,126,462,588,113,570,683,504,118,1530
27/4/2021,Selangor,4742,1227,4532,129,141,270,88,140,228,492,380,2499
27/4/2021,Terengganu,1307,288,1287,4,10,14,4,14,18,34,47,877
27/4/2021,W.P. Kuala Lumpur,3997,254,3930,5,18,23,3,8,11,121,31,1972
27/4/2021,W.P. Labuan,122,25,112,0,0,0,0,0,0,2,2,63
28/4/2021,Johor,4550,983,4409,129,94,223,67,57,124,494,129,3407
28/4/2021,Kedah,1844,215,1783,4,7,11,0,10,10,127,4,1476
28/4/2021,Kelantan,2704,429,2575,1,75,76,5,72,77,365,3,1434
28/4/2021,Melaka,1101,125,1048,6,7,13,0,10,10,56,11,869
28/4/2021,Negeri Sembilan,1251,503,1204,1,27,28,3,6,9,145,4,788
28/4/2021,Pahang,2170,701,2113,1,5,6,1,5,6,51,3,1191
28/4/2021,Perak,2728,270,2654,0,12,12,1,10,11,97,7,1861
28/4/2021,Perlis,508,57,493,1,1,2,1,0,1,8,3,289
28/4/2021,Pulau Pinang,1292,248,1249,0,25,25,0,16,16,133,0,760
28/4/2021,Sabah,2948,660,2810,13,19,32,9,19,28,248,49,1648
28/4/2021,Sarawak,3334,914,3179,118,428,546,72,375,447,488,138,1547
28/4/2021,Selangor,4742,1227,4532,136,136,272,117,114,231,510,381,2484
28/4/2021,Terengganu,1307,288,1287,4,16,20,8,1,9,49,40,918
28/4/2021,W.P. Kuala Lumpur,3997,254,3930,4,19,23,3,8,11,115,34,2028
28/4/2021,W.P. Labuan,122,25,112,1,0,1,0,0,0,2,3,67
29/4/2021,Johor,4576,745,4435,71,85,156,63,55,118,527,123,3183
29/4/2021,Kedah,1844,215,1783,6,21,27,1,13,14,142,5,1446
29/4/2021,Kelantan,2736,479,2607,2,70,72,0,60,60,370,2,1302
29/4/2021,Melaka,1101,125,1048,1,10,11,1,7,8,59,11,862
29/4/2021,Negeri Sembilan,1251,503,1204,0,24,24,0,10,10,158,4,783
29/4/2021,Pahang,2170,701,2113,1,8,9,6,10,16,24,21,1215
29/4/2021,Perak,2728,270,2654,0,25,25,0,16,16,106,4,1775
29/4/2021,Perlis,508,57,493,1,0,1,0,1,1,7,4,267
29/4/2021,Pulau Pinang,1292,248,1249,0,23,23,0,9,9,142,0,717
29/4/2021,Sabah,2948,660,2810,8,20,28,17,23,40,228,45,1696
29/4/2021,Sarawak,3334,914,3179,131,338,469,145,392,537,519,177,1562
29/4/2021,Selangor,4742,1227,4532,162,168,330,126,164,290,530,350,2445
29/4/2021,Terengganu,1307,288,1287,2,11,13,5,10,15,51,40,821
29/4/2021,W.P. Kuala Lumpur,3997,254,3930,2,17,19,8,9,17,128,35,1864
29/4/2021,W.P. Labuan,122,25,112,0,0,0,1,1,2,1,2,70
30/4/2021,Johor,4576,741,4435,102,108,210,65,66,131,565,124,3036
30/4/2021,Kedah,1844,215,1781,3,22,25,0,17,17,155,6,1367
30/4/2021,Kelantan,2736,497,2602,0,59,59,1,54,55,363,0,1290
30/4/2021,Melaka,1101,125,1048,4,14,18,0,9,9,64,15,842
30/4/2021,Negeri Sembilan,1251,503,1204,1,22,23,3,24,27,148,2,775
30/4/2021,Pahang,2170,701,2113,1,4,5,3,1,4,27,19,1167
30/4/2021,Perak,2728,270,2654,1,26,27,0,16,16,116,8,1781
30/4/2021,Perlis,508,57,493,0,1,1,0,1,1,7,4,274
30/4/2021,Pulau Pinang,1292,248,1249,0,27,27,0,25,25,139,0,716
30/4/2021,Sabah,2948,660,2810,5,29,34,9,26,35,231,38,1674
30/4/2021,Sarawak,2809,824,2654,128,488,616,131,501,632,497,148,1536
30/4/2021,Selangor,4742,1227,4532,150,163,313,42,158,200,548,427,2424
30/4/2021,Terengganu,1307,288,1287,2,6,8,13,9,22,49,24,718
30/4/2021,W.P. Kuala Lumpur,3997,281,3930,3,31,34,3,9,12,161,38,1854
30/4/2021,W.P. Labuan,122,25,112,0,0,0,0,0,0,1,2,63
1/5/2021,Johor,4576,741,4427,113,81,194,82,70,152,585,132,2966
1/5/2021,Kedah,1844,215,1781,4,29,33,3,23,26,176,5,1313
1/5/2021,Kelantan,2736,497,2602,2,73,75,2,54,56,375,3,1220
1/5/2021,Melaka,1101,125,1048,0,15,15,1,14,15,65,14,803
1/5/2021,Negeri Sembilan,1251,503,1204,1,16,17,0,6,6,155,3,739
1/5/2021,Pahang,2170,701,2113,0,15,15,1,5,6,49,3,1125
1/5/2021,Perak,2728,270,2654,0,24,24,0,14,14,113,2,1643
1/5/2021,Perlis,508,57,493,7,0,7,3,2,5,5,9,259
1/5/2021,Pulau Pinang,1292,248,1249,0,28,28,0,28,28,132,0,679
1/5/2021,Sabah,2948,660,2806,7,19,26,11,30,41,212,33,1565
1/5/2021,Sarawak,2809,824,2654,122,388,510,93,436,529,491,125,1546
1/5/2021,Selangor,4742,1261,4532,141,160,301,66,149,215,555,297,2401
1/5/2021,Terengganu,1307,288,1267,8,8,16,11,5,16,51,22,798
1/5/2021,W.P. Kuala Lumpur,3997,281,3930,3,15,18,3,5,8,134,47,1808
1/5/2021,W.P. Labuan,122,25,112,0,0,0,0,0,0,1,2,49
2/5/2021,Johor,4576,760,4427,76,105,181,60,64,124,589,100,3086
2/5/2021,Kedah,1844,215,1781,1,19,20,0,26,26,153,3,1349
2/5/2021,Kelantan,2736,525,2602,1,105,106,3,59,62,427,1,1174
2/5/2021,Melaka,1101,125,1041,0,17,17,6,8,14,74,8,763
2/5/2021,Negeri Sembilan,1251,503,1204,0,21,21,0,16,16,158,2,729
2/5/2021,Pahang,2170,701,2113,0,11,11,3,9,12,51,0,1144
2/5/2021,Perak,2728,270,2654,0,12,12,1,4,5,122,4,1578
2/5/2021,Perlis,508,57,493,0,0,0,5,0,5,5,4,242
2/5/2021,Pulau Pinang,1292,248,1249,0,24,24,0,12,12,142,0,664
2/5/2021,Sabah,2948,649,2804,10,32,42,8,24,32,239,35,1530
2/5/2021,Sarawak,2809,824,2640,145,571,716,89,372,461,513,150,1539
2/5/2021,Selangor,4742,1261,4552,132,187,319,89,145,234,589,297,2342
2/5/2021,Terengganu,1307,288,1267,4,13,17,4,7,11,59,20,800
2/5/2021,W.P. Kuala Lumpur,3997,281,3930,0,23,23,4,13,17,128,54,1814
2/5/2021,W.P. Labuan,122,25,112,0,0,0,0,0,0,1,2,47
3/5/2021,Johor,4645,778,4496,101,114,215,52,81,133,626,141,3060
3/5/2021,Kedah,1844,215,1781,4,21,25,0,15,15,170,8,1381
3/5/2021,Kelantan,2736,542,2602,4,63,67,0,79,79,425,5,1277
3/5/2021,Melaka,1101,125,1041,0,14,14,2,9,11,78,6,777
3/5/2021,Negeri Sembilan,1251,503,1204,0,18,18,0,9,9,162,0,730
3/5/2021,Pahang,2170,701,2113,5,16,21,0,8,8,60,5,1072
3/5/2021,Perak,2728,288,2654,0,36,36,0,11,11,141,7,1648
3/5/2021,Perlis,508,57,493,2,3,5,2,1,3,7,4,260
3/5/2021,Pulau Pinang,1292,248,1249,0,30,30,0,17,17,152,0,718
3/5/2021,Sabah,2948,671,2804,9,19,28,6,22,28,220,40,1531
3/5/2021,Sarawak,2809,824,2632,105,326,431,83,357,440,551,145,1565
3/5/2021,Selangor,4742,1261,4552,129,152,281,106,155,261,591,328,2361
3/5/2021,Terengganu,1307,288,1267,9,6,15,3,3,6,64,26,823
3/5/2021,W.P. Kuala Lumpur,3997,348,3930,2,35,37,0,15,15,161,54,1857
3/5/2021,W.P. Labuan,122,25,112,0,0,0,0,0,0,1,2,46
4/5/2021,Johor,4775,894,4626,132,126,258,86,65,151,643,138,3203
4/5/2021,Kedah,1844,215,1781,4,13,17,1,27,28,168,4,1420
4/5/2021,Kelantan,2704,510,2570,4,61,65,2,64,66,425,7,1325
4/5/2021,Melaka,1101,125,1033,1,21,22,0,8,8,91,7,801
4/5/2021,Negeri Sembilan,1251,503,1204,0,32,32,0,14,14,181,2,780
4/5/2021,Pahang,2170,701,2113,4,18,22,1,8,9,70,8,1181
4/5/2021,Perak,2728,288,2653,1,33,34,0,6,6,158,9,1737
4/5/2021,Perlis,508,57,493,6,0,6,2,1,3,6,8,278
4/5/2021,Pulau Pinang,1292,248,1242,0,29,29,0,15,15,157,0,872
4/5/2021,Sabah,2948,671,2804,8,21,29,14,31,45,201,33,1638
4/5/2021,Sarawak,2809,824,2632,129,442,571,89,340,429,547,191,1559
4/5/2021,Selangor,4742,1261,4552,148,144,292,111,167,278,574,285,2429
4/5/2021,Terengganu,1307,288,1267,8,11,19,8,8,16,67,24,838
4/5/2021,W.P. Kuala Lumpur,3997,448,3930,22,33,55,0,12,12,150,74,1231
4/5/2021,W.P. Labuan,122,25,112,0,0,0,0,1,1,0,2,54
5/5/2021,Johor,5026,964,4877,101,122,223,98,63,161,695,159,3337
5/5/2021,Kedah,1844,252,1781,4,42,46,0,18,18,195,4,1373
5/5/2021,Kelantan,2704,534,2570,3,49,52,4,55,59,416,6,1348
5/5/2021,Melaka,1101,125,1033,2,21,23,4,10,14,102,5,830
5/5/2021,Negeri Sembilan,1251,503,1204,1,23,24,1,14,15,187,2,807
5/5/2021,Pahang,2170,701,2113,4,23,27,6,5,11,89,6,984
5/5/2021,Perak,2728,312,2655,1,19,20,0,14,14,160,11,1792
5/5/2021,Perlis,508,57,493,7,1,8,2,2,4,5,15,272
5/5/2021,Pulau Pinang,1292,248,1242,0,22,22,0,25,25,148,0,689
5/5/2021,Sabah,2948,671,2804,13,22,35,2,18,20,200,41,1650
5/5/2021,Sarawak,2809,839,2632,115,409,524,163,430,593,549,164,1562
5/5/2021,Selangor,4742,1261,4552,96,234,330,42,198,240,636,313,2376
5/5/2021,Terengganu,1307,288,1267,8,21,29,6,10,16,78,26,851
5/5/2021,W.P. Kuala Lumpur,3997,448,3930,2,38,40,3,23,26,238,63,2064
5/5/2021,W.P. Labuan,122,25,112,0,0,0,0,0,0,0,2,59
6/5/2021,Johor,5026,964,4877,110,132,242,159,120,279,700,138,3298
6/5/2021,Kedah,1844,255,1781,1,22,23,0,25,25,196,3,1338
6/5/2021,Kelantan,2704,534,2570,4,88,92,5,63,68,435,5,1340
6/5/2021,Melaka,1101,125,1033,0,14,14,0,11,11,107,5,785
6/5/2021,Negeri Sembilan,1251,503,1204,0,39,39,0,26,26,194,0,794
6/5/2021,Pahang,2170,701,2113,4,20,24,3,5,8,104,7,1236
6/5/2021,Perak,2728,312,2655,0,24,24,1,9,10,172,9,1831
6/5/2021,Perlis,508,57,493,6,2,8,1,2,3,4,15,265
6/5/2021,Pulau Pinang,1292,248,1242,0,44,44,0,16,16,172,0,780
6/5/2021,Sabah,2948,671,2804,9,22,31,10,26,36,197,37,1682
6/5/2021,Sarawak,2809,839,2632,174,343,517,61,305,366,562,191,1532
6/5/2021,Selangor,4742,1261,4552,132,168,300,113,150,263,654,317,2331
6/5/2021,Terengganu,1307,288,1267,8,10,18,5,11,16,76,32,823
6/5/2021,W.P. Kuala Lumpur,3997,448,3930,3,43,46,3,35,38,243,61,1884
6/5/2021,W.P. Labuan,122,25,112,1,0,1,1,0,1,0,3,63
7/5/2021,Johor,5026,1005,4877,135,113,248,109,88,197,739,180,3073
7/5/2021,Kedah,1844,255,1781,0,20,20,0,16,16,185,2,1246
7/5/2021,Kelantan,2704,534,2570,3,77,80,5,69,74,442,3,1232
7/5/2021,Melaka,1101,125,1033,0,18,18,0,18,18,107,5,803
7/5/2021,Negeri Sembilan,1251,503,1204,4,42,46,1,24,25,211,5,788
7/5/2021,Pahang,2170,701,2102,4,31,35,2,10,12,123,9,1116
7/5/2021,Perak,2728,312,2655,1,18,19,0,16,16,170,8,1805
7/5/2021,Perlis,508,57,493,1,5,6,2,0,2,9,13,278
7/5/2021,Pulau Pinang,1292,248,1242,0,31,31,0,23,23,166,0,753
7/5/2021,Sabah,2948,671,2804,11,25,36,7,19,26,207,42,1647
7/5/2021,Sarawak,2809,839,2632,114,355,469,93,477,570,520,167,1568
7/5/2021,Selangor,4742,1261,4545,138,191,329,96,150,246,717,313,2301
7/5/2021,Terengganu,1307,288,1267,12,15,27,2,6,8,85,42,832
7/5/2021,W.P. Kuala Lumpur,3997,452,3930,4,52,56,7,19,26,272,60,1859
7/5/2021,W.P. Labuan,122,25,112,0,1,1,0,0,0,1,3,66
8/5/2021,Johor,5026,1005,4877,104,100,204,89,74,163,754,141,3103
8/5/2021,Kedah,1844,255,1781,5,29,34,0,22,22,193,6,1269
8/5/2021,Kelantan,2704,534,2570,2,63,65,1,74,75,424,4,1199
8/5/2021,Melaka,1101,131,1033,0,22,22,0,3,3,125,6,749
8/5/2021,Negeri Sembilan,1251,503,1204,0,39,39,0,19,19,226,2,704
8/5/2021,Pahang,2170,701,2102,2,33,35,2,14,16,142,6,1081
8/5/2021,Perak,2728,312,2655,1,21,22,0,15,15,176,10,1669
8/5/2021,Perlis,508,57,493,3,2,5,8,2,10,9,8,285
8/5/2021,Pulau Pinang,1292,248,1261,0,31,31,0,12,12,168,0,714
8/5/2021,Sabah,2948,671,2804,11,18,29,8,18,26,209,44,1598
8/5/2021,Sarawak,2809,839,2632,77,366,443,89,392,481,529,139,1969
8/5/2021,Selangor,4742,1267,4545,103,174,277,90,170,260,699,289,2170
8/5/2021,Terengganu,1307,288,1267,20,19,39,10,5,15,101,50,819
8/5/2021,W.P. Kuala Lumpur,3997,452,3930,3,32,35,2,17,19,285,63,1662
8/5/2021,W.P. Labuan,122,25,112,1,0,1,0,0,0,1,4,53
9/5/2021,Johor,5026,1025,4877,96,102,198,80,85,165,770,155,3155
9/5/2021,Kedah,1844,255,1781,6,42,48,0,11,11,222,7,1300
9/5/2021,Kelantan,2704,534,2573,5,69,74,1,43,44,448,8,1264
9/5/2021,Melaka,1101,131,1033,0,24,24,1,8,9,140,5,723
9/5/2021,Negeri Sembilan,1251,503,1204,3,33,36,0,22,22,235,6,675
9/5/2021,Pahang,2170,701,2102,8,43,51,3,11,14,172,10,1010
9/5/2021,Perak,2728,312,2655,1,20,21,0,23,23,174,11,1595
9/5/2021,Perlis,508,57,493,5,1,6,1,0,1,10,11,260
9/5/2021,Pulau Pinang,1292,248,1261,0,37,37,0,15,15,178,0,691
9/5/2021,Sabah,2948,698,2804,9,20,29,18,21,39,206,40,1501
9/5/2021,Sarawak,2809,839,2632,139,536,675,74,285,359,512,193,1462
9/5/2021,Selangor,4742,1267,4545,79,198,277,39,181,220,702,314,2092
9/5/2021,Terengganu,1307,288,1267,4,13,17,6,10,16,104,48,824
9/5/2021,W.P. Kuala Lumpur,3997,542,3930,4,49,53,10,17,27,329,59,1606
9/5/2021,W.P. Labuan,122,25,112,1,0,1,0,0,0,1,5,50
10/5/2021,Johor,5112,1097,4959,99,126,225,62,101,163,779,140,3099
10/5/2021,Kedah,1844,255,1781,4,34,38,0,36,36,226,7,1286
10/5/2021,Kelantan,2704,552,2573,5,67,72,9,64,73,452,4,1277
10/5/2021,Melaka,1101,133,1033,2,25,27,1,22,23,143,6,725
10/5/2021,Negeri Sembilan,1251,503,1204,0,22,22,2,25,27,233,4,707
10/5/2021,Pahang,2170,701,2102,4,38,42,4,19,23,190,10,975
10/5/2021,Perak,2728,320,2655,1,13,14,1,7,8,181,8,1554
10/5/2021,Perlis,508,57,493,3,4,7,0,0,0,11,14,269
10/5/2021,Pulau Pinang,1292,248,1261,0,31,31,0,14,14,193,0,684
10/5/2021,Sabah,2948,698,2804,5,6,11,8,15,23,201,36,1466
10/5/2021,Sarawak,2809,839,2632,131,498,629,68,532,600,527,198,1469
10/5/2021,Selangor,5724,1487,5486,156,227,383,99,224,323,776,401,2900
10/5/2021,Terengganu,1307,288,1267,13,34,47,15,7,22,131,37,841
10/5/2021,W.P. Kuala Lumpur,3997,596,3930,6,60,66,4,16,20,382,43,1657
10/5/2021,W.P. Labuan,122,25,112,0,1,1,0,0,0,2,4,58
11/5/2021,Johor,5112,1171,4955,120,128,248,95,85,180,793,147,3070
11/5/2021,Kedah,1844,255,1779,1,38,39,0,36,36,234,5,1211
11/5/2021,Kelantan,2704,572,2573,3,56,59,1,75,76,427,6,1216
11/5/2021,Melaka,1101,208,1033,3,25,28,1,8,9,157,9,717
11/5/2021,Negeri Sembilan,1251,503,1204,2,62,64,0,30,30,260,6,705
11/5/2021,Pahang,2170,701,2102,5,29,34,2,18,20,200,13,972
11/5/2021,Perak,2728,342,2655,2,17,19,0,47,47,146,18,1544
11/5/2021,Perlis,508,57,493,6,2,8,3,0,3,14,18,273
11/5/2021,Pulau Pinang,1292,248,1261,0,31,31,0,23,23,190,0,679
11/5/2021,Sabah,2948,698,2804,12,17,29,6,25,31,192,42,1560
11/5/2021,Sarawak,2809,839,2632,107,371,478,67,518,585,502,158,1485
11/5/2021,Selangor,5724,1487,5490,176,186,362,99,161,260,802,423,2744
11/5/2021,Terengganu,1307,288,1267,12,17,29,12,14,26,133,41,731
11/5/2021,W.P. Kuala Lumpur,3997,600,3930,1,48,49,4,22,26,403,57,1596
11/5/2021,W.P. Labuan,122,25,112,0,0,0,2,1,3,4,2,61
11/5/2021,W.P. Putrajaya,397,10,371,0,0,0,0,0,0,4,0,6
12/5/2021,Johor,5112,1171,4955,95,145,240,113,118,231,811,145,2929
12/5/2021,Kedah,1844,283,1779,0,32,32,0,26,26,233,3,1138
12/5/2021,Kelantan,2704,578,2573,4,84,88,5,81,86,423,5,1130
12/5/2021,Melaka,1101,208,1033,7,12,19,4,11,15,158,12,683
12/5/2021,Negeri Sembilan,1251,503,1204,2,36,38,0,28,28,260,8,710
12/5/2021,Pahang,2170,701,2102,0,49,49,7,24,31,222,3,936
12/5/2021,Perak,2728,342,2655,2,22,24,0,10,10,157,14,1486
12/5/2021,Perlis,508,57,493,4,2,6,10,3,13,13,9,240
12/5/2021,Pulau Pinang,1292,248,1256,0,35,35,0,26,26,196,0,674
12/5/2021,Sabah,2948,698,2804,9,56,65,11,28,39,206,39,1568
12/5/2021,Sarawak,2809,839,2632,148,510,658,110,483,593,552,172,1535
12/5/2021,Selangor,5724,1487,5495,155,218,373,131,183,314,809,346,2714
12/5/2021,Terengganu,1307,288,1267,13,19,32,13,18,31,133,43,793
12/5/2021,W.P. Kuala Lumpur,3997,600,3930,14,75,89,0,42,42,439,62,1506
12/5/2021,W.P. Labuan,122,25,112,0,1,1,0,0,0,5,1,52
12/5/2021,W.P. Putrajaya,397,28,371,2,0,2,2,2,4,2,5,224
13/5/2021,Johor,5112,1171,4955,81,130,211,71,119,190,813,137,2625
13/5/2021,Kedah,1924,406,1859,3,55,58,0,32,32,269,5,970
13/5/2021,Kelantan,2704,574,2573,3,81,84,5,88,93,415,3,859
13/5/2021,Melaka,1101,208,1029,3,23,26,3,14,17,167,12,684
13/5/2021,Negeri Sembilan,1251,503,1204,4,43,47,6,38,44,257,6,653
13/5/2021,Pahang,2170,701,2102,3,26,29,1,30,31,224,5,818
13/5/2021,Perak,2728,342,2655,2,31,33,1,17,18,170,13,1285
13/5/2021,Perlis,508,57,496,9,0,9,3,2,5,7,12,197
13/5/2021,Pulau Pinang,1292,248,1252,0,47,47,0,28,28,199,0,602
13/5/2021,Sabah,2948,698,2804,9,38,47,11,17,28,211,35,1354
13/5/2021,Sarawak,2809,839,2632,153,421,574,201,483,684,531,164,1370
13/5/2021,Selangor,5724,1487,5495,186,248,434,195,240,435,835,406,2267
13/5/2021,Terengganu,1307,288,1267,10,17,27,12,21,33,128,48,637
13/5/2021,W.P. Kuala Lumpur,3997,600,3930,4,73,77,4,26,30,456,56,1363
13/5/2021,W.P. Labuan,122,25,112,0,0,0,0,0,0,4,1,2
13/5/2021,W.P. Putrajaya,397,28,377,0,3,3,5,2,7,3,0,210
14/5/2021,Johor,5112,1171,4954,60,116,176,59,70,129,884,116,2888
14/5/2021,Kedah,1924,406,1859,6,36,42,0,29,29,273,8,965
14/5/2021,Kelantan,2704,574,2563,7,54,61,3,72,75,396,7,900
14/5/2021,Melaka,1101,208,1029,9,26,35,9,16,25,177,12,566
14/5/2021,Negeri Sembilan,1251,503,1204,1,38,39,6,38,44,255,1,536
14/5/2021,Pahang,2170,701,2102,2,23,25,0,32,32,214,6,798
14/5/2021,Perak,2728,342,2655,0,38,38,0,21,21,184,10,1277
14/5/2021,Perlis,508,57,496,3,1,4,4,0,4,8,12,187
14/5/2021,Pulau Pinang,1292,248,1252,0,45,45,0,24,24,210,0,577
14/5/2021,Sabah,2948,698,2804,6,21,27,2,17,19,197,38,1387
14/5/2021,Sarawak,2809,839,2632,84,282,366,49,398,447,547,159,1461
14/5/2021,Selangor,5724,1487,5484,121,214,335,90,166,256,876,354,2278
14/5/2021,Terengganu,1307,288,1267,2,23,25,7,17,24,133,45,584
14/5/2021,W.P. Kuala Lumpur,3997,659,3909,3,47,50,4,28,32,488,64,1419
14/5/2021,W.P. Labuan,122,25,112,0,0,0,0,1,1,3,1,39
14/5/2021,W.P. Putrajaya,397,28,377,0,1,1,0,0,0,4,0,7
15/5/2021,Johor,5112,1182,4954,170,115,285,68,124,192,894,159,2742
15/5/2021,Kedah,1924,406,1846,3,35,38,0,23,23,290,5,1073
15/5/2021,Kelantan,2704,574,2563,6,100,106,3,62,65,424,10,986
15/5/2021,Melaka,1101,208,1029,7,18,25,3,28,31,167,16,576
15/5/2021,Negeri Sembilan,1251,503,1204,8,58,66,0,34,34,263,9,571
15/5/2021,Pahang,2170,701,2102,4,30,34,5,34,39,209,5,859
15/5/2021,Perak,2728,342,2655,1,42,43,2,16,18,207,15,1310
15/5/2021,Perlis,508,57,496,3,3,6,0,0,0,8,10,217
15/5/2021,Pulau Pinang,1292,248,1252,0,36,36,0,17,17,213,0,564
15/5/2021,Sabah,2948,698,2804,8,24,32,11,21,32,188,36,1444
15/5/2021,Sarawak,2809,839,2632,89,308,397,73,382,455,511,158,1455
15/5/2021,Selangor,5724,1580,5484,161,227,388,135,200,335,906,339,2440
15/5/2021,Terengganu,1307,288,1267,9,28,37,21,13,34,149,30,751
15/5/2021,W.P. Kuala Lumpur,3997,710,3909,5,73,78,6,34,40,515,71,1359
15/5/2021,W.P. Labuan,122,25,112,0,0,0,0,0,0,3,1,44
15/5/2021,W.P. Putrajaya,397,28,377,0,3,3,0,1,1,6,0,216
16/5/2021,Johor,5112,1182,4938,114,115,229,88,95,183,907,140,2841
16/5/2021,Kedah,1924,406,1846,1,30,31,0,34,34,285,6,1070
16/5/2021,Kelantan,2704,574,2563,13,62,75,0,50,50,436,23,1119
16/5/2021,Melaka,1101,208,1029,1,22,23,4,21,25,168,13,600
16/5/2021,Negeri Sembilan,1251,503,1204,7,65,72,2,21,23,305,13,550
16/5/2021,Pahang,2170,701,2102,2,64,66,2,27,29,236,5,933
16/5/2021,Perak,2728,342,2653,0,38,38,1,21,22,216,10,1333
16/5/2021,Perlis,508,57,496,3,2,5,0,0,0,9,13,232
16/5/2021,Pulau Pinang,1292,248,1252,0,35,35,0,26,26,214,0,592
16/5/2021,Sabah,2948,698,2804,3,27,30,9,22,31,187,33,1376
16/5/2021,Sarawak,2809,839,2632,94,250,344,50,432,482,468,166,1436
16/5/2021,Selangor,5724,1580,5464,181,232,413,111,185,296,957,383,2507
16/5/2021,Terengganu,1307,288,1267,13,34,47,3,14,17,170,37,813
16/5/2021,W.P. Kuala Lumpur,3997,767,3909,5,56,61,7,24,31,536,68,1193
16/5/2021,W.P. Labuan,122,25,112,0,0,0,1,0,1,4,0,52
16/5/2021,W.P. Putrajaya,397,14,377,0,2,2,0,0,0,8,0,7
17/5/2021,Johor,5112,1182,4938,127,157,284,73,78,151,977,143,2942
17/5/2021,Kedah,1924,406,1844,3,26,29,0,39,39,291,6,1172
17/5/2021,Kelantan,2704,574,2563,9,103,112,23,83,106,445,9,1238
17/5/2021,Melaka,1101,208,1029,0,25,25,3,33,36,170,10,645
17/5/2021,Negeri Sembilan,1251,503,1204,1,48,49,3,41,44,311,11,570
17/5/2021,Pahang,2210,721,2142,5,57,62,1,34,35,266,7,988
17/5/2021,Perak,2728,352,2640,0,36,36,0,26,26,216,11,1477
17/5/2021,Perlis,508,57,496,11,1,12,4,0,4,8,20,247
17/5/2021,Pulau Pinang,1292,248,1250,0,45,45,0,24,24,224,0,610
17/5/2021,Sabah,2948,698,2808,6,31,37,2,16,18,202,39,1462
17/5/2021,Sarawak,2809,839,2632,106,282,388,71,393,464,520,152,1517
17/5/2021,Selangor,5724,1580,5435,168,239,407,111,193,304,1019,358,2613
17/5/2021,Terengganu,1307,288,1267,11,17,28,7,16,23,171,36,864
17/5/2021,W.P. Kuala Lumpur,3997,767,3901,4,69,73,6,34,40,553,64,1356
17/5/2021,W.P. Labuan,122,25,112,1,1,2,0,0,0,4,1,52
17/5/2021,W.P. Putrajaya,397,14,377,0,3,3,0,2,2,9,0,6
18/5/2021,Johor,5112,1196,4938,104,123,227,93,115,208,964,152,3039
18/5/2021,Kedah,1924,406,1844,2,36,38,0,21,21,300,5,1217
18/5/2021,Kelantan,2704,574,2563,6,73,79,7,64,71,454,8,1341
18/5/2021,Melaka,1101,208,1009,2,19,21,3,10,13,178,10,709
18/5/2021,Negeri Sembilan,1251,503,1204,2,55,57,3,39,42,318,10,625
18/5/2021,Pahang,2210,721,2142,14,37,51,6,34,40,262,15,1128
18/5/2021,Perak,2728,362,2640,1,33,34,1,31,32,217,14,1579
18/5/2021,Perlis,508,57,496,6,3,9,6,1,7,10,15,279
18/5/2021,Pulau Pinang,1292,248,1247,0,28,28,0,10,10,224,0,673
18/5/2021,Sabah,2948,698,2808,8,46,54,5,33,38,211,38,1574
18/5/2021,Sarawak,2809,839,2632,122,376,498,72,391,463,502,156,1565
18/5/2021,Selangor,5724,1623,5433,148,231,379,70,202,272,521,874,2675
18/5/2021,Terengganu,1307,288,1267,11,33,44,9,24,33,180,39,736
18/5/2021,W.P. Kuala Lumpur,3997,767,3901,16,76,92,4,35,39,576,71,1529
18/5/2021,W.P. Labuan,122,25,112,2,0,2,0,0,0,4,3,63
18/5/2021,W.P. Putrajaya,397,20,377,1,2,3,0,0,0,11,2,257
19/5/2021,Johor,5112,1196,4938,137,185,322,86,127,213,993,212,3080
19/5/2021,Kedah,1924,406,1844,0,36,36,0,14,14,331,3,1229
19/5/2021,Kelantan,2704,574,2563,8,88,96,4,62,66,472,12,1341
19/5/2021,Melaka,1101,208,1009,8,22,30,5,21,26,179,13,707
19/5/2021,Negeri Sembilan,1251,503,1204,1,55,56,4,25,29,318,7,626
19/5/2021,Pahang,2210,728,2142,7,56,63,3,24,27,304,20,1121
19/5/2021,Perak,2728,362,2640,1,40,41,1,20,21,237,12,1661
19/5/2021,Perlis,508,57,493,9,3,12,6,0,6,14,19,274
19/5/2021,Pulau Pinang,1292,248,1247,0,38,38,0,32,32,223,0,692
19/5/2021,Sabah,2948,698,2808,7,33,40,2,17,19,227,41,1660
19/5/2021,Sarawak,2809,839,2632,137,358,495,62,331,393,498,184,1629
19/5/2021,Selangor,5724,1712,5433,172,260,432,100,218,318,1074,400,2738
19/5/2021,Terengganu,1307,324,1267,10,40,50,4,24,28,193,44,776
19/5/2021,W.P. Kuala Lumpur,3997,849,3901,12,86,98,9,51,60,596,83,1584
19/5/2021,W.P. Labuan,122,25,112,10,0,10,0,2,2,2,13,68
19/5/2021,W.P. Putrajaya,397,20,377,2,2,4,2,0,2,13,2,278
20/5/2021,Johor,5112,1196,4938,137,178,315,88,182,270,1000,164,3126
20/5/2021,Kedah,2662,502,2559,4,46,50,0,15,15,364,4,1647
20/5/2021,Kelantan,2704,574,2563,7,81,88,5,72,77,479,14,1341
20/5/2021,Melaka,1101,208,1009,9,25,34,7,26,33,178,15,681
20/5/2021,Negeri Sembilan,1251,503,1198,12,78,90,7,24,31,366,12,596
20/5/2021,Pahang,2210,728,2142,7,60,67,11,59,70,307,15,994
20/5/2021,Perak,2728,362,2640,2,44,46,1,13,14,265,6,1673
20/5/2021,Perlis,508,57,493,7,5,12,4,0,4,16,14,256
20/5/2021,Pulau Pinang,1292,294,1247,0,45,45,0,39,39,227,0,695
20/5/2021,Sabah,2948,717,2804,12,47,59,7,16,23,262,45,1547
20/5/2021,Sarawak,2809,839,2632,104,338,442,72,383,455,495,192,1634
20/5/2021,Selangor,5724,1752,5431,148,279,427,82,224,306,1142,405,2755
20/5/2021,Terengganu,1307,324,1267,11,43,54,4,35,39,199,44,792
20/5/2021,W.P. Kuala Lumpur,4198,886,4090,8,83,91,16,64,80,659,76,1646
20/5/2021,W.P. Labuan,122,25,112,10,3,13,0,0,0,5,23,64
20/5/2021,W.P. Putrajaya,397,20,377,3,3,6,2,2,4,14,3,263
21/5/2021,Johor,5112,1248,4938,129,177,306,91,127,218,1014,200,2923
21/5/2021,Kedah,2662,479,2559,1,73,74,0,26,26,411,10,1440
21/5/2021,Kelantan,2704,574,2563,7,72,79,11,86,97,462,10,1240
21/5/2021,Melaka,1101,208,1009,6,29,35,6,14,20,191,17,692
21/5/2021,Negeri Sembilan,1251,503,1198,9,74,83,2,35,37,395,19,547
21/5/2021,Pahang,2210,728,2142,4,62,66,10,47,57,323,9,981
21/5/2021,Perak,2728,436,2640,1,41,42,1,21,22,278,13,1616
21/5/2021,Perlis,508,57,493,7,2,9,3,1,4,13,17,273
21/5/2021,Pulau Pinang,1292,294,1247,0,43,43,0,50,50,228,0,692
21/5/2021,Sabah,2948,717,2804,16,25,41,16,8,24,171,38,1307
21/5/2021,Sarawak,2809,839,2632,140,399,539,68,424,492,495,190,1638
21/5/2021,Selangor,5724,1762,5431,165,239,404,99,186,285,1187,392,2784
21/5/2021,Terengganu,1307,324,1267,18,32,50,10,28,38,202,58,695
21/5/2021,W.P. Kuala Lumpur,4198,886,4059,5,93,98,6,42,48,678,80,1760
21/5/2021,W.P. Labuan,122,25,112,16,1,17,2,0,2,6,38,52
21/5/2021,W.P. Putrajaya,397,20,377,3,2,5,3,6,9,10,0,249
22/5/2021,Johor,5112,1248,4952,102,155,257,92,124,216,1021,197,2876
22/5/2021,Kedah,2662,479,2559,11,38,49,0,27,27,420,18,1460
22/5/2021,Kelantan,2704,574,2563,9,85,94,8,66,74,466,11,1213
22/5/2021,Melaka,1101,208,1009,6,45,51,3,19,22,214,20,674
22/5/2021,Negeri Sembilan,1327,545,1274,7,119,126,7,25,32,468,16,445
22/5/2021,Pahang,2210,728,2142,6,33,39,1,53,54,301,14,321
22/5/2021,Perak,2728,436,2640,0,43,43,0,28,28,286,11,1510
22/5/2021,Perlis,487,85,472,4,4,8,4,1,5,15,14,253
22/5/2021,Pulau Pinang,1292,294,1247,0,39,39,0,45,45,245,0,678
22/5/2021,Sabah,2948,717,2804,13,40,53,14,23,37,290,48,1548
22/5/2021,Sarawak,2809,839,2632,118,445,563,71,391,462,492,172,1624
22/5/2021,Selangor,5724,1850,5431,174,248,422,101,251,352,1192,409,2666
22/5/2021,Terengganu,1307,324,1267,13,19,32,7,18,25,197,63,756
22/5/2021,W.P. Kuala Lumpur,4198,901,4059,12,96,108,10,71,81,698,81,1606
22/5/2021,W.P. Labuan,122,25,112,0,5,5,0,0,0,11,24,56
22/5/2021,W.P. Putrajaya,397,20,377,1,2,3,3,4,7,8,1,270
23/5/2021,Johor,5112,1248,4950,84,205,289,69,136,205,1074,171,2948
23/5/2021,Kedah,2662,479,2559,3,46,49,0,26,26,436,13,1565
23/5/2021,Kelantan,2704,580,2563,20,81,101,6,60,66,482,25,1270
23/5/2021,Melaka,1101,208,1009,0,4,4,7,18,25,233,19,661
23/5/2021,Negeri Sembilan,1327,545,1274,13,106,119,4,42,46,514,22,413
23/5/2021,Pahang,2210,728,2142,10,85,95,4,60,64,325,20,907
23/5/2021,Perak,2728,436,2640,2,34,36,0,42,42,270,16,1467
23/5/2021,Perlis,487,85,472,7,3,10,3,0,3,15,18,258
23/5/2021,Pulau Pinang,1292,294,1247,0,35,35,0,43,43,248,0,621
23/5/2021,Sabah,2948,717,2804,7,21,28,6,15,21,186,45,1236
23/5/2021,Sarawak,2809,839,2632,149,356,505,75,346,421,518,153,1566
23/5/2021,Selangor,5724,1945,5409,196,251,447,90,218,308,1247,473,2823
23/5/2021,Terengganu,1307,324,1267,9,30,39,9,23,32,204,50,759
23/5/2021,W.P. Kuala Lumpur,4198,901,4023,21,151,172,20,124,144,715,77,1613
23/5/2021,W.P. Labuan,122,25,112,0,2,2,3,0,3,13,17,50
23/5/2021,W.P. Putrajaya,397,20,377,1,2,3,3,4,7,8,1,265
24/5/2021,Johor,5112,1250,4950,122,142,264,72,136,208,1081,202,3017
24/5/2021,Kedah,2662,479,2559,1,63,64,0,28,28,497,3,1547
24/5/2021,Kelantan,2704,580,2563,15,86,101,12,83,95,481,28,1339
24/5/2021,Melaka,1101,208,1009,3,30,33,8,26,34,237,14,657
24/5/2021,Negeri Sembilan,1431,683,1367,5,116,121,10,52,62,528,17,437
24/5/2021,Pahang,2210,728,2142,7,65,72,5,27,32,358,17,963
24/5/2021,Perak,2728,436,2640,3,40,43,1,22,23,292,20,1461
24/5/2021,Perlis,487,85,472,4,2,6,4,2,6,15,14,285
24/5/2021,Pulau Pinang,1292,294,1247,0,44,44,0,36,36,244,0,632
24/5/2021,Sabah,2948,697,2804,11,41,52,10,18,28,327,47,1584
24/5/2021,Sarawak,2809,839,2632,133,359,492,66,303,369,538,177,1593
24/5/2021,Selangor,5768,1945,5457,178,265,443,110,231,341,1281,486,2706
24/5/2021,Terengganu,1307,324,1267,13,37,50,9,7,16,232,53,739
24/5/2021,W.P. Kuala Lumpur,4198,970,4023,7,106,113,3,44,47,750,68,1601
24/5/2021,W.P. Labuan,122,25,112,0,0,0,2,0,2,12,4,50
24/5/2021,W.P. Putrajaya,397,20,377,1,4,5,4,1,5,14,3,265
25/5/2021,Johor,5160,1281,4998,127,145,272,91,155,246,1086,216,3030
25/5/2021,Kedah,2662,605,2559,2,58,60,1,59,60,515,4,1591
25/5/2021,Kelantan,2704,580,2563,8,69,77,12,82,94,474,24,1311
25/5/2021,Melaka,1101,208,1009,2,20,22,5,15,20,262,11,676
25/5/2021,Negeri Sembilan,1431,683,1367,5,114,119,8,51,59,567,14,646
25/5/2021,Pahang,2210,728,2142,10,73,83,6,53,59,375,18,984
25/5/2021,Perak,2728,432,2640,5,41,46,0,35,35,294,20,1522
25/5/2021,Perlis,487,85,472,1,4,5,1,0,1,19,12,310
25/5/2021,Pulau Pinang,1292,294,1241,0,42,42,0,44,44,248,0,642
25/5/2021,Sabah,2948,697,2804,20,51,71,4,26,30,331,61,1677
25/5/2021,Sarawak,2809,839,2634,112,412,524,56,416,472,522,238,1598
25/5/2021,Selangor,5768,1946,5457,183,275,458,119,265,384,1269,505,2737
25/5/2021,Terengganu,1407,374,1367,11,36,47,6,21,27,247,59,722
25/5/2021,W.P. Kuala Lumpur,4198,970,4021,2,111,113,4,77,81,789,57,1650
25/5/2021,W.P. Labuan,122,25,112,1,2,3,0,0,0,14,5,41
25/5/2021,W.P. Putrajaya,397,20,377,2,2,4,3,1,4,15,2,256
26/5/2021,Johor,5160,1281,4998,126,225,351,90,160,250,1138,246,2990
26/5/2021,Kedah,2662,605,2559,4,79,83,0,56,56,522,4,1541
26/5/2021,Kelantan,2704,580,2560,6,57,63,6,72,78,453,24,1234
26/5/2021,Melaka,1101,208,1009,2,18,20,2,16,18,264,11,664
26/5/2021,Negeri Sembilan,1431,713,1367,18,106,124,9,28,37,617,13,533
26/5/2021,Pahang,2210,728,2142,11,48,59,8,45,53,379,16,950
26/5/2021,Perak,2728,432,2640,1,42,43,1,33,34,278,14,1538
26/5/2021,Perlis,487,85,472,6,3,9,6,1,7,22,14,304
26/5/2021,Pulau Pinang,1292,319,1241,0,63,63,0,44,44,269,0,705
26/5/2021,Sabah,2948,697,2804,26,56,82,16,24,40,344,65,1697
26/5/2021,Sarawak,2809,839,2634,113,350,463,69,415,484,540,185,1617
26/5/2021,Selangor,5768,1953,5457,155,314,469,136,288,424,1292,465,2859
26/5/2021,Terengganu,1407,374,1367,11,34,45,11,43,54,234,65,781
26/5/2021,W.P. Kuala Lumpur,4198,1001,4021,12,112,124,5,74,79,821,69,1598
26/5/2021,W.P. Labuan,122,25,112,6,4,10,0,1,1,17,11,42
26/5/2021,W.P. Putrajaya,397,20,377,0,6,6,2,3,5,18,0,263
27/5/2021,Johor,5160,1281,4998,234,157,391,84,108,192,1168,240,2963
27/5/2021,Kedah,2755,614,2626,2,80,82,1,48,49,547,3,1568
27/5/2021,Kelantan,2704,580,2560,22,100,122,15,56,71,496,31,1209
27/5/2021,Melaka,1101,208,1009,0,10,10,1,33,34,241,10,672
27/5/2021,Negeri Sembilan,1431,763,1367,0,130,130,5,41,46,670,8,568
27/5/2021,Pahang,2210,728,2142,8,67,75,5,42,47,393,23,986
27/5/2021,Perak,2728,432,2640,0,40,40,0,20,20,296,14,1593
27/5/2021,Perlis,487,85,471,11,2,13,5,1,6,26,16,322
27/5/2021,Pulau Pinang,1292,319,1241,0,42,42,0,47,47,266,0,711
27/5/2021,Sabah,2948,697,2804,12,51,63,6,18,24,358,65,1641
27/5/2021,Sarawak,2809,839,2634,96,339,435,62,266,328,503,190,1532
27/5/2021,Selangor,5768,1975,5453,186,321,507,127,250,377,1352,469,3003
27/5/2021,Terengganu,1407,374,1367,10,18,28,13,24,37,229,61,757
27/5/2021,W.P. Kuala Lumpur,4198,1009,4016,8,92,100,11,84,95,834,70,1696
27/5/2021,W.P. Labuan,122,25,112,0,10,10,1,0,1,27,10,4
27/5/2021,W.P. Putrajaya,397,25,377,2,7,9,0,2,2,23,2,264
28/5/2021,Johor,5160,1281,4998,107,166,273,65,114,179,1225,300,2621
28/5/2021,Kedah,2755,614,2626,179,75,254,5,45,50,571,6,1854
28/5/2021,Kelantan,2704,585,2560,6,95,101,15,80,95,502,22,1135
28/5/2021,Melaka,1101,208,1009,1,52,53,3,32,35,261,8,638
28/5/2021,Negeri Sembilan,1431,763,1367,5,85,90,4,62,66,649,9,554
28/5/2021,Pahang,2210,728,2142,7,76,83,11,52,63,416,17,972
28/5/2021,Perak,2728,452,2640,2,51,53,1,42,43,297,7,1597
28/5/2021,Perlis,487,85,471,8,9,17,1,1,2,31,21,312
28/5/2021,Pulau Pinang,1292,319,1241,0,39,39,0,42,42,267,0,708
28/5/2021,Sabah,2948,733,2804,13,38,51,19,18,37,327,59,1717
28/5/2021,Sarawak,2809,839,2634,117,436,553,92,498,590,530,211,1612
28/5/2021,Selangor,5768,1991,5453,154,285,439,90,267,357,1369,417,2332
28/5/2021,Terengganu,1407,374,1367,12,34,46,4,33,37,232,57,726
28/5/2021,W.P. Kuala Lumpur,4198,1022,4014,12,95,107,10,96,106,838,58,1767
28/5/2021,W.P. Labuan,122,25,112,0,1,1,0,0,0,28,7,52
28/5/2021,W.P. Putrajaya,397,30,377,0,6,6,0,2,2,27,2,279
29/5/2021,Johor,5160,1322,4998,115,181,296,91,161,252,1214,271,2737
29/5/2021,Kedah,2755,614,2630,5,75,80,0,61,61,570,6,1485
29/5/2021,Kelantan,2704,585,2560,8,89,97,15,91,106,499,15,1156
29/5/2021,Melaka,1101,208,1009,1,40,41,2,35,37,266,7,601
29/5/2021,Negeri Sembilan,1431,763,1367,7,139,146,3,94,97,647,13,552
29/5/2021,Pahang,2210,728,2142,10,60,70,12,97,109,393,17,973
29/5/2021,Perak,2728,452,2640,0,58,58,0,43,43,292,12,1506
29/5/2021,Perlis,487,85,471,4,5,9,1,2,3,34,20,283
29/5/2021,Pulau Pinang,1292,319,1241,0,43,43,0,47,47,268,0,648
29/5/2021,Sabah,2948,733,2804,8,48,56,17,34,51,347,48,1648
29/5/2021,Sarawak,2809,839,2634,117,403,520,71,493,564,524,181,1528
29/5/2021,Selangor,5768,2011,5453,169,275,444,128,285,413,1341,388,2669
29/5/2021,Terengganu,1407,374,1367,5,20,25,6,27,33,219,62,723
29/5/2021,W.P. Kuala Lumpur,4198,1102,4014,10,71,81,5,89,94,829,64,1666
29/5/2021,W.P. Labuan,122,25,112,1,7,8,0,2,2,33,8,52
29/5/2021,W.P. Putrajaya,397,30,377,1,3,4,0,6,6,24,3,259
30/5/2021,Johor,5160,1322,4998,104,167,271,59,160,219,1215,270,2802
30/5/2021,Kedah,2755,614,2630,3,76,79,0,47,47,576,6,1584
30/5/2021,Kelantan,2710,591,2566,13,96,109,3,73,76,518,25,1205
30/5/2021,Melaka,1101,250,1009,6,47,53,2,23,25,290,11,596
30/5/2021,Negeri Sembilan,1431,781,1367,8,131,139,6,86,92,689,15,514
30/5/2021,Pahang,2210,842,2142,8,51,59,8,90,98,391,17,984
30/5/2021,Perak,2728,452,2640,0,44,44,1,30,31,301,10,1478
30/5/2021,Perlis,487,85,471,8,3,11,4,2,6,32,23,275
30/5/2021,Pulau Pinang,1292,319,1241,0,43,43,0,47,47,271,0,646
30/5/2021,Sabah,2948,733,2804,7,68,75,14,18,32,380,38,1541
30/5/2021,Sarawak,2809,851,2634,89,463,552,71,464,535,538,180,1493
30/5/2021,Selangor,5768,2017,5446,137,257,394,156,278,434,1386,363,2646
30/5/2021,Terengganu,1407,374,1367,13,34,47,23,29,52,217,53,753
30/5/2021,W.P. Kuala Lumpur,4198,1102,4014,7,85,92,3,63,66,864,68,1665
30/5/2021,W.P. Labuan,122,25,112,3,0,3,0,0,0,33,11,52
30/5/2021,W.P. Putrajaya,397,30,377,3,4,7,3,6,9,22,3,164
31/5/2021,Johor,5160,1344,4998,139,200,339,110,158,268,1238,283,2742
31/5/2021,Kedah,2755,614,2630,2,69,71,0,61,61,607,4,1520
31/5/2021,Kelantan,2710,591,2566,8,85,93,10,99,109,500,23,1222
31/5/2021,Melaka,1101,250,1009,2,28,30,4,36,40,282,9,607
31/5/2021,Negeri Sembilan,1431,781,1363,13,76,89,4,73,77,647,24,555
31/5/2021,Pahang,2250,842,2182,8,55,63,8,73,81,352,21,864
31/5/2021,Perak,2728,452,2640,2,42,44,1,36,37,304,10,1475
31/5/2021,Perlis,487,85,471,16,7,23,2,1,3,38,33,256
31/5/2021,Pulau Pinang,1292,319,1236,0,38,38,0,53,53,249,0,625
31/5/2021,Sabah,2948,733,2804,20,68,88,5,21,26,382,48,1248
31/5/2021,Sarawak,2809,851,2634,110,307,417,73,445,518,541,170,1463
31/5/2021,Selangor,5768,2017,5446,163,239,402,86,249,335,1346,383,2672
31/5/2021,Terengganu,1407,374,1367,14,21,35,14,34,48,203,53,741
31/5/2021,W.P. Kuala Lumpur,4198,1102,4014,5,92,97,9,69,78,883,69,1585
31/5/2021,W.P. Labuan,122,58,106,1,0,1,0,0,0,32,12,50
31/5/2021,W.P. Putrajaya,397,30,377,3,4,7,1,4,5,22,6,267
1/6/2021,Johor,5160,1344,4998,107,129,236,95,111,206,1229,291,2732
1/6/2021,Kedah,2755,614,2630,1,69,70,0,73,73,579,1,1493
1/6/2021,Kelantan,2710,589,2566,25,97,122,11,79,90,511,37,1281
1/6/2021,Melaka,1101,250,1009,5,40,45,4,28,32,295,9,609
1/6/2021,Negeri Sembilan,1431,894,1363,7,121,128,10,80,90,653,21,481
1/6/2021,Pahang,2250,842,2182,6,60,66,12,55,67,366,17,950
1/6/2021,Perak,2728,480,2640,1,45,46,0,46,46,290,15,1564
1/6/2021,Perlis,487,85,471,10,0,10,6,1,7,37,34,251
1/6/2021,Pulau Pinang,1292,319,1236,0,51,51,0,47,47,268,0,659
1/6/2021,Sabah,2948,733,2804,13,37,50,7,21,28,401,59,1420
1/6/2021,Sarawak,3531,977,3356,159,389,548,96,373,469,570,215,1672
1/6/2021,Selangor,5768,2017,5446,167,258,425,147,286,433,1319,447,2847
1/6/2021,Terengganu,1407,374,1367,12,32,44,6,33,39,201,58,3
1/6/2021,W.P. Kuala Lumpur,4198,1123,4017,9,106,115,15,98,113,876,61,1652
1/6/2021,W.P. Labuan,122,58,106,0,27,27,2,2,4,57,8,50
1/6/2021,W.P. Putrajaya,397,31,377,4,7,11,3,5,8,24,7,265
2/6/2021,Johor,5160,1385,4998,79,131,210,108,117,225,1176,229,2751
2/6/2021,Kedah,2755,614,2639,3,68,71,0,71,71,559,8,1458
2/6/2021,Kelantan,2743,622,2599,10,108,118,7,65,72,548,40,1245
2/6/2021,Melaka,1101,250,1009,2,28,30,1,21,22,301,11,612
2/6/2021,Negeri Sembilan,1431,894,1363,3,102,105,7,81,88,631,11,590
2/6/2021,Pahang,2250,842,2182,7,60,67,6,50,56,376,18,980
2/6/2021,Perak,2728,480,2640,5,39,44,1,43,44,282,10,1603
2/6/2021,Perlis,487,85,471,11,2,13,9,5,14,35,23,251
2/6/2021,Pulau Pinang,1292,319,1236,0,37,37,0,45,45,262,0,678
2/6/2021,Sabah,2948,733,2804,9,67,76,12,34,46,377,59,1463
2/6/2021,Sarawak,3531,977,3356,123,449,572,74,436,510,608,210,1698
2/6/2021,Selangor,5768,2017,5446,128,271,399,86,255,341,1315,431,2592
2/6/2021,Terengganu,1407,374,1367,8,24,32,10,32,42,191,59,759
2/6/2021,W.P. Kuala Lumpur,4198,1143,4022,8,93,101,11,102,113,849,54,1654
2/6/2021,W.P. Labuan,122,58,106,0,0,0,0,1,1,53,5,54
2/6/2021,W.P. Putrajaya,397,31,377,0,0,0,0,0,0,24,7,259
3/6/2021,Johor,5160,1385,4998,99,125,224,83,119,202,1213,228,2791
3/6/2021,Kedah,2755,614,2639,4,54,58,0,68,68,547,6,1471
3/6/2021,Kelantan,2743,622,2599,9,77,86,11,88,99,529,38,1275
3/6/2021,Melaka,1101,250,1009,3,33,36,4,40,44,294,10,619
3/6/2021,Negeri Sembilan,1431,894,1363,14,137,151,3,71,74,679,21,571
3/6/2021,Pahang,2250,842,2182,5,44,49,4,61,65,352,19,968
3/6/2021,Perak,2728,480,2640,4,40,44,0,33,33,282,16,1628
3/6/2021,Perlis,487,85,471,11,9,20,3,4,7,40,17,240
3/6/2021,Pulau Pinang,1292,319,1236,0,36,36,0,45,45,239,0,705
3/6/2021,Sabah,2948,733,2804,17,61,78,9,27,36,383,61,1370
3/6/2021,Sarawak,3531,977,3356,89,427,516,93,485,578,606,220,1696
3/6/2021,Selangor,5768,2017,5446,182,268,450,108,287,395,1287,481,2619
3/6/2021,Terengganu,1407,374,1367,16,31,47,13,22,35,191,62,754
3/6/2021,W.P. Kuala Lumpur,4198,1132,4022,8,90,98,6,80,86,848,53,1774
3/6/2021,W.P. Labuan,122,58,106,5,2,7,0,2,2,53,10,62
3/6/2021,W.P. Putrajaya,397,31,377,2,4,6,5,8,13,22,5,278
4/6/2021,Johor,5160,1385,4998,98,175,273,109,171,280,1194,191,2662
4/6/2021,Kedah,2755,614,2639,0,40,40,0,70,70,512,0,1416
4/6/2021,Kelantan,2743,622,2599,11,70,81,16,77,93,524,32,1220
4/6/2021,Melaka,1101,250,1009,6,26,32,4,35,39,285,12,628
4/6/2021,Negeri Sembilan,1431,894,1363,5,109,114,12,73,85,687,14,522
4/6/2021,Pahang,2250,842,2182,8,37,45,10,73,83,313,18,947
4/6/2021,Perak,2728,480,2640,2,39,41,2,45,47,276,15,1619
4/6/2021,Perlis,487,85,471,14,6,20,0,0,0,43,28,248
4/6/2021,Pulau Pinang,1292,319,1234,0,41,41,0,47,47,230,0,712
4/6/2021,Sabah,2948,777,2804,13,43,56,12,37,49,394,58,1505
4/6/2021,Sarawak,3531,977,3356,143,431,574,84,576,660,498,238,1713
4/6/2021,Selangor,5768,2017,5446,159,240,399,139,274,413,1281,453,2581
4/6/2021,Terengganu,1407,374,1367,7,22,29,7,27,34,185,60,705
4/6/2021,W.P. Kuala Lumpur,4198,1132,4022,12,66,78,11,86,97,840,53,1856
4/6/2021,W.P. Labuan,122,72,106,2,1,3,1,1,2,54,12,62
4/6/2021,W.P. Putrajaya,397,31,377,3,4,7,1,5,6,21,7,290
5/6/2021,Johor,5160,1385,4998,77,144,221,79,150,229,1175,175,2633
5/6/2021,Kedah,2755,614,2639,3,58,61,1,24,25,521,3,1429
5/6/2021,Kelantan,2743,622,2599,7,51,58,9,70,79,501,30,1198
5/6/2021,Melaka,1101,250,1009,4,33,37,3,32,35,286,13,598
5/6/2021,Negeri Sembilan,1431,894,1363,2,153,155,11,94,105,743,5,524
5/6/2021,Pahang,2250,842,2182,15,45,60,7,59,66,298,25,933
5/6/2021,Perak,2728,480,2640,4,40,44,5,45,50,264,9,1552
5/6/2021,Perlis,487,85,471,12,1,13,6,7,13,38,26,239
5/6/2021,Pulau Pinang,1292,319,1234,0,43,43,0,43,43,232,0,644
5/6/2021,Sabah,2948,777,2804,13,49,62,16,29,45,403,51,1508
5/6/2021,Sarawak,3531,977,3356,104,425,529,95,405,500,605,196,1653
5/6/2021,Selangor,5768,2042,5444,234,276,510,101,252,353,1303,433,2557
5/6/2021,Terengganu,1407,374,1367,5,41,46,5,22,27,199,44,725
5/6/2021,W.P. Kuala Lumpur,4198,1132,4022,15,124,139,12,149,161,814,55,1658
5/6/2021,W.P. Labuan,122,72,106,3,5,8,0,1,1,54,15,60
5/6/2021,W.P. Putrajaya,397,31,377,0,6,6,5,6,11,21,2,267
6/6/2021,Johor,5160,1385,4998,102,157,259,69,107,176,1196,184,2705
6/6/2021,Kedah,2755,661,2639,2,32,34,0,58,58,499,3,1462
6/6/2021,Kelantan,2743,622,2599,11,69,80,14,53,67,512,27,1218
6/6/2021,Melaka,1101,250,1009,2,23,25,0,22,22,287,15,572
6/6/2021,Negeri Sembilan,1431,935,1351,0,118,118,2,65,67,764,3,464
6/6/2021,Pahang,2250,842,2182,5,57,62,7,66,73,299,23,918
6/6/2021,Perak,2728,480,2640,0,36,36,0,28,28,270,8,1525
6/6/2021,Perlis,487,85,471,20,1,21,3,4,7,31,30,245
6/6/2021,Pulau Pinang,1292,319,1234,0,37,37,0,44,44,221,0,626
6/6/2021,Sabah,2948,777,2804,13,52,65,6,38,44,402,58,1418
6/6/2021,Sarawak,3531,977,3356,120,530,650,84,438,522,609,188,1684
6/6/2021,Selangor,5768,2082,5444,188,241,429,96,217,313,1303,532,2362
6/6/2021,Terengganu,1407,374,1367,10,21,31,5,23,28,194,44,747
6/6/2021,W.P. Kuala Lumpur,4198,1140,4022,5,72,77,3,84,87,789,55,1529
6/6/2021,W.P. Labuan,122,72,106,0,8,8,1,0,1,61,10,70
6/6/2021,W.P. Putrajaya,397,31,377,1,6,7,2,2,4,25,1,266
7/6/2021,Johor,5160,1385,4998,112,118,230,114,155,269,1142,176,2755
7/6/2021,Kedah,2755,661,2639,1,35,36,0,39,39,478,3,1477
7/6/2021,Kelantan,2743,622,2599,11,63,74,10,86,96,485,27,1300
7/6/2021,Melaka,1101,250,1009,3,23,26,1,19,20,285,13,562
7/6/2021,Negeri Sembilan,1431,935,1351,2,101,103,2,69,71,725,2,484
7/6/2021,Pahang,2250,842,2182,11,35,46,10,57,67,275,23,308
7/6/2021,Perak,2728,480,2640,3,26,29,1,27,28,262,14,1480
7/6/2021,Perlis,487,85,471,6,1,7,3,3,6,29,14,233
7/6/2021,Pulau Pinang,1292,319,1234,0,26,26,0,23,23,221,0,599
7/6/2021,Sabah,2948,777,2804,18,61,79,15,25,40,422,55,1490
7/6/2021,Sarawak,3531,977,3356,137,576,713,106,493,599,611,178,1721
7/6/2021,Selangor,5768,2092,5444,145,222,367,93,232,325,1307,528,2303
7/6/2021,Terengganu,1407,374,1367,10,25,35,8,37,45,178,39,760
7/6/2021,W.P. Kuala Lumpur,4198,1140,4022,5,66,71,6,63,69,780,46,1560
7/6/2021,W.P. Labuan,122,72,106,2,0,2,0,1,1,54,12,57
7/6/2021,W.P. Putrajaya,397,31,377,1,2,3,0,5,5,22,2,255
8/6/2021,Johor,5160,1385,4998,81,132,213,75,106,181,1142,163,2845
8/6/2021,Kedah,2755,661,2639,0,31,31,0,53,53,462,2,1484
8/6/2021,Kelantan,2743,622,2599,11,62,73,8,70,78,474,30,1356
8/6/2021,Melaka,1101,250,1009,5,23,28,1,34,35,285,17,598
8/6/2021,Negeri Sembilan,1431,935,1351,7,115,122,0,73,73,723,8,477
8/6/2021,Pahang,2250,842,2182,10,22,32,5,44,49,249,24,951
8/6/2021,Perak,2728,480,2635,1,20,21,1,38,39,239,15,1531
8/6/2021,Perlis,487,87,471,14,2,16,4,4,8,27,18,231
8/6/2021,Pulau Pinang,1292,319,1234,0,19,19,0,37,37,202,0,638
8/6/2021,Sabah,2948,777,2804,15,56,71,15,36,51,427,57,1413
8/6/2021,Sarawak,3531,977,3356,162,525,687,92,549,641,623,187,1761
8/6/2021,Selangor,5768,2100,5444,114,248,362,95,227,322,1300,517,2412
8/6/2021,Terengganu,1407,374,1367,4,10,14,5,25,30,161,36,722
8/6/2021,W.P. Kuala Lumpur,4198,1140,4022,6,74,80,5,87,92,781,43,1641
8/6/2021,W.P. Labuan,122,72,106,0,8,8,0,1,1,58,8,60
8/6/2021,W.P. Putrajaya,397,31,377,1,3,4,0,0,0,25,3,257
9/6/2021,Johor,5160,1385,4998,86,142,228,74,126,200,1128,161,2855
9/6/2021,Kedah,2755,661,2639,0,19,19,0,67,67,408,1,1480
9/6/2021,Kelantan,2743,622,2599,7,52,59,12,60,72,458,26,1366
9/6/2021,Melaka,1101,290,1009,0,41,41,1,37,38,289,16,596
9/6/2021,Negeri Sembilan,1431,935,1351,8,90,98,2,115,117,673,7,380
9/6/2021,Pahang,2250,842,2182,10,52,62,11,35,46,268,29,1024
9/6/2021,Perak,2728,480,2635,1,34,35,3,44,47,228,11,1579
9/6/2021,Perlis,487,87,471,10,0,10,2,1,3,26,20,239
9/6/2021,Pulau Pinang,1292,319,1234,0,24,24,0,38,38,184,0,678
9/6/2021,Sabah,2948,777,2782,15,45,60,14,26,40,429,55,1541
9/6/2021,Sarawak,3531,977,3356,86,423,509,131,413,544,614,168,1781
9/6/2021,Selangor,5768,2127,5444,134,248,382,115,195,310,1341,481,2628
9/6/2021,Terengganu,1407,641,1367,8,20,28,9,30,39,252,54,608
9/6/2021,W.P. Kuala Lumpur,4198,1140,4013,1,69,70,3,101,104,747,47,1696
9/6/2021,W.P. Labuan,122,72,106,0,6,6,0,6,6,64,5,60
9/6/2021,W.P. Putrajaya,397,31,377,1,4,5,1,2,3,27,3,266
10/6/2021,Johor,5160,1385,4998,98,168,266,77,142,219,1115,174,2903
10/6/2021,Kedah,2755,661,2639,1,29,30,0,53,53,377,2,1483
10/6/2021,Kelantan,2743,622,2599,8,72,80,9,80,89,455,25,1347
10/6/2021,Melaka,1101,290,1009,7,28,35,9,35,44,282,14,618
10/6/2021,Negeri Sembilan,1431,935,1351,6,156,162,6,88,94,710,7,468
10/6/2021,Pahang,2250,842,2182,6,41,47,6,44,50,259,28,985
10/6/2021,Perak,2728,480,2635,0,24,24,1,36,37,211,10,1656
10/6/2021,Perlis,487,87,471,13,2,15,6,1,7,27,18,255
10/6/2021,Pulau Pinang,1292,319,1232,0,20,20,0,25,25,171,0,665
10/6/2021,Sabah,2948,777,2782,18,47,65,14,40,54,428,51,1581
10/6/2021,Sarawak,3531,1001,3356,152,331,483,116,500,616,596,179,1808
10/6/2021,Selangor,5768,2147,5444,193,267,460,90,256,346,1343,543,2599
10/6/2021,Terengganu,1407,641,1367,12,28,40,8,21,29,257,54,633
10/6/2021,W.P. Kuala Lumpur,4198,1140,4013,21,88,109,6,90,96,743,71,1672
10/6/2021,W.P. Labuan,122,72,99,0,0,0,0,0,0,56,1,56
10/6/2021,W.P. Putrajaya,397,31,377,4,5,9,3,10,13,22,4,279
11/6/2021,Johor,5160,1485,4998,122,152,274,80,151,231,1089,192,2782
11/6/2021,Kedah,2755,661,2639,1,40,41,0,47,47,359,13,1394
11/6/2021,Kelantan,2743,622,2599,8,68,76,5,66,71,455,28,1294
11/6/2021,Melaka,1101,290,1009,7,17,24,5,36,41,262,17,635
11/6/2021,Negeri Sembilan,1431,935,1351,2,106,108,3,106,109,690,6,477
11/6/2021,Pahang,2250,842,2182,9,30,39,11,34,45,250,27,962
11/6/2021,Perak,2728,480,2635,1,23,24,1,39,40,191,18,1606
11/6/2021,Perlis,487,87,471,13,0,13,2,4,6,22,25,250
11/6/2021,Pulau Pinang,1292,319,1232,0,30,30,0,34,34,162,0,657
11/6/2021,Sabah,3120,787,2954,21,76,97,20,31,51,441,57,1610
11/6/2021,Sarawak,3531,1001,3356,176,391,567,88,454,542,600,184,1842
11/6/2021,Selangor,5768,2167,5444,162,262,424,133,209,342,1385,559,2605
11/6/2021,Terengganu,1407,641,1367,11,13,24,4,26,30,242,57,597
11/6/2021,W.P. Kuala Lumpur,4198,1140,4013,15,90,105,7,61,68,743,73,1710
11/6/2021,W.P. Labuan,122,72,99,5,3,8,0,0,0,59,6,74
11/6/2021,W.P. Putrajaya,397,31,377,0,2,2,3,5,8,19,1,272
12/6/2021,Johor,5160,1485,4998,96,98,194,77,99,176,1095,150,2871
12/6/2021,Kedah,2755,661,2639,1,40,41,0,52,52,331,1,1442
12/6/2021,Kelantan,2743,622,2599,4,62,66,7,49,56,464,26,1254
12/6/2021,Melaka,1101,290,1009,7,35,42,5,33,38,267,7,630
12/6/2021,Negeri Sembilan,1431,935,1351,6,120,126,2,98,100,680,9,479
12/6/2021,Pahang,2250,842,2182,5,36,41,9,69,78,221,22,934
12/6/2021,Perak,2728,480,2635,0,23,23,2,36,38,175,16,1516
12/6/2021,Perlis,487,87,471,18,3,21,1,1,2,24,31,261
12/6/2021,Pulau Pinang,1292,319,1232,0,29,29,0,31,31,159,0,602
12/6/2021,Sabah,3120,797,2954,10,51,61,6,46,52,428,60,1536
12/6/2021,Sarawak,3531,1001,3356,141,408,549,80,320,400,595,179,1755
12/6/2021,Selangor,5768,2139,5441,117,250,367,93,227,320,1380,527,2476
12/6/2021,Terengganu,1407,641,1367,10,22,32,13,59,72,203,54,618
12/6/2021,W.P. Kuala Lumpur,4198,1140,4013,9,103,112,10,92,102,885,56,1586
12/6/2021,W.P. Labuan,122,72,99,0,0,0,0,0,0,40,5,63
12/6/2021,W.P. Putrajaya,397,31,377,1,5,6,1,4,5,20,1,260
13/6/2021,Johor,5160,1485,4998,70,83,153,61,119,180,1044,175,2866
13/6/2021,Kedah,2755,661,2639,0,38,38,0,18,18,351,0,1476
13/6/2021,Kelantan,2743,622,2599,7,57,64,8,72,80,444,25,1346
13/6/2021,Melaka,1101,290,1009,7,32,39,4,28,32,271,10,655
13/6/2021,Negeri Sembilan,1431,991,1351,9,127,136,4,89,93,694,14,479
13/6/2021,Pahang,2250,842,2182,5,24,29,7,30,37,226,21,890
13/6/2021,Perak,2728,480,2635,0,15,15,0,29,29,165,18,1477
13/6/2021,Perlis,487,87,471,5,3,8,1,3,4,22,13,285
13/6/2021,Pulau Pinang,1292,319,1232,0,28,28,0,15,15,161,0,580
13/6/2021,Sabah,3120,797,2954,22,47,69,17,37,54,419,65,1513
13/6/2021,Sarawak,3531,1001,3356,168,387,555,101,530,631,594,184,1750
13/6/2021,Selangor,5768,2139,5441,156,246,402,125,217,342,1364,523,2449
13/6/2021,Terengganu,1407,641,1367,3,28,31,12,30,42,200,45,607
13/6/2021,W.P. Kuala Lumpur,4198,1140,4013,5,92,97,4,54,58,787,60,1646
13/6/2021,W.P. Labuan,122,72,99,4,23,27,1,26,27,80,9,72
13/6/2021,W.P. Putrajaya,397,31,377,1,6,7,0,4,4,22,2,243
14/6/2021,Johor,5160,1485,4998,114,118,232,64,147,211,975,183,3185
14/6/2021,Kedah,2755,661,2639,1,39,40,0,37,37,341,3,1571
14/6/2021,Kelantan,2743,622,2599,6,39,45,12,82,94,400,18,1362
14/6/2021,Melaka,1101,290,1009,12,35,47,10,27,37,278,11,650
14/6/2021,Negeri Sembilan,1431,991,1351,1,149,150,7,76,83,708,8,505
14/6/2021,Pahang,2250,842,2182,9,22,31,2,26,28,219,29,914
14/6/2021,Perak,2728,480,2635,1,20,21,0,29,29,162,14,1486
14/6/2021,Perlis,487,87,471,12,1,13,1,2,3,21,17,271
14/6/2021,Pulau Pinang,1292,319,1232,0,25,25,0,31,31,160,0,607
14/6/2021,Sabah,3120,797,2954,8,51,59,21,27,48,429,52,1546
14/6/2021,Sarawak,3531,1001,3356,136,418,554,85,483,568,612,171,1739
14/6/2021,Selangor,5768,2139,5441,134,240,374,122,233,355,1364,508,2588
14/6/2021,Terengganu,1407,641,1367,2,18,20,16,37,53,180,31,596
14/6/2021,W.P. Kuala Lumpur,4198,1140,4013,6,63,69,2,65,67,781,61,1667
14/6/2021,W.P. Labuan,122,72,99,1,0,1,0,0,0,72,14,71
14/6/2021,W.P. Putrajaya,397,31,377,0,3,3,0,3,3,22,2,224
15/6/2021,Johor,5160,1485,4998,126,131,257,123,140,263,954,201,2965
15/6/2021,Kedah,2755,661,2639,2,53,55,0,35,35,349,2,1555
15/6/2021,Kelantan,2743,622,2599,7,76,83,9,41,50,429,14,1396
15/6/2021,Melaka,1101,290,1009,2,19,21,5,27,32,270,9,705
15/6/2021,Negeri Sembilan,1431,991,1356,4,157,161,4,80,84,761,8,512
15/6/2021,Pahang,2250,842,2182,8,24,32,14,35,49,207,22,976
15/6/2021,Perak,2728,480,2635,1,19,20,0,29,29,154,16,1573
15/6/2021,Perlis,487,87,471,7,1,8,3,4,7,17,14,275
15/6/2021,Pulau Pinang,1292,319,1232,0,22,22,0,21,21,158,0,668
15/6/2021,Sabah,3120,850,2954,18,35,53,9,40,49,419,58,1568
15/6/2021,Sarawak,3679,1001,3496,160,533,693,98,628,726,611,184,1844
15/6/2021,Selangor,5768,2201,5441,173,228,401,113,200,313,1380,560,2587
15/6/2021,Terengganu,1407,641,1367,4,15,19,14,42,56,153,20,632
15/6/2021,W.P. Kuala Lumpur,4198,1140,4013,8,89,97,13,78,91,788,70,1724
15/6/2021,W.P. Labuan,122,72,99,0,0,0,0,10,10,70,13,63
15/6/2021,W.P. Putrajaya,397,31,377,2,5,7,1,5,6,22,3,232
16/6/2021,Johor,5160,1485,4998,94,114,208,95,120,215,933,191,2997
16/6/2021,Kedah,2755,661,2639,0,37,37,0,33,33,346,1,1575
16/6/2021,Kelantan,2743,622,2599,3,60,63,6,63,69,424,14,1397
16/6/2021,Melaka,1101,290,1009,8,33,41,4,22,26,281,10,720
16/6/2021,Negeri Sembilan,1431,991,1356,3,128,131,3,83,86,773,8,543
16/6/2021,Pahang,2250,842,2175,9,17,26,6,43,49,180,24,1013
16/6/2021,Perak,2728,448,2635,0,9,9,1,15,16,144,16,1665
16/6/2021,Perlis,487,87,471,7,1,8,4,1,5,19,12,280
16/6/2021,Pulau Pinang,1292,319,1232,0,19,19,0,20,20,153,0,679
16/6/2021,Sabah,3120,850,2954,18,66,84,13,41,54,434,61,1476
16/6/2021,Sarawak,3699,1001,3516,167,355,522,82,462,544,601,186,1912
16/6/2021,Selangor,5768,2201,5441,157,235,392,106,269,375,1342,438,2717
16/6/2021,Terengganu,1407,641,1367,7,11,18,6,25,31,139,24,708
16/6/2021,W.P. Kuala Lumpur,4198,1140,4013,8,83,91,7,55,62,809,81,1800
16/6/2021,W.P. Labuan,122,72,99,0,15,15,1,6,7,69,11,68
16/6/2021,W.P. Putrajaya,397,31,377,2,6,8,0,5,5,22,5,237
17/6/2021,Johor,5160,1485,4998,96,147,243,86,133,219,944,171,3040
17/6/2021,Kedah,2755,661,2639,0,48,48,0,29,29,357,0,1578
17/6/2021,Kelantan,2743,622,2547,10,74,84,11,57,68,431,13,1411
17/6/2021,Melaka,1101,290,1009,5,34,39,5,24,29,291,10,693
17/6/2021,Negeri Sembilan,1431,991,1356,3,144,147,2,77,79,802,9,548
17/6/2021,Pahang,2250,842,2175,4,27,31,9,30,39,177,19,1003
17/6/2021,Perak,2728,448,2635,1,8,9,0,29,29,123,18,1680
17/6/2021,Perlis,487,87,471,3,0,3,0,0,0,19,11,261
17/6/2021,Pulau Pinang,1292,319,1232,0,20,20,0,20,20,157,0,682
17/6/2021,Sabah,3120,850,2954,6,61,67,16,45,61,435,54,1611
17/6/2021,Sarawak,3699,1001,3516,132,593,725,98,353,451,611,179,1871
17/6/2021,Selangor,5768,2204,5441,184,294,478,125,249,374,1367,523,2670
17/6/2021,Terengganu,1407,641,1367,6,14,20,3,27,30,126,26,677
17/6/2021,W.P. Kuala Lumpur,4198,1140,4013,6,76,82,8,66,74,818,69,1842
17/6/2021,W.P. Labuan,122,72,99,0,0,0,1,7,8,73,8,68
17/6/2021,W.P. Putrajaya,397,31,377,3,4,7,4,8,12,18,5,247
18/6/2021,Johor,5160,1485,4998,127,136,263,70,161,231,923,219,2866
18/6/2021,Kedah,2755,661,2639,0,46,46,0,44,44,355,0,1574
18/6/2021,Kelantan,2743,622,2547,7,54,61,9,62,71,437,11,1312
18/6/2021,Melaka,1101,290,1009,10,36,46,9,30,39,296,11,681
18/6/2021,Negeri Sembilan,1431,991,1362,2,154,156,3,75,78,869,5,506
18/6/2021,Pahang,2250,842,2175,9,23,32,6,27,33,174,23,951
18/6/2021,Perak,2728,448,2635,0,16,16,0,19,19,124,15,1700
18/6/2021,Perlis,487,87,471,5,2,7,0,3,3,18,13,260
18/6/2021,Pulau Pinang,1292,319,1232,0,16,16,0,26,26,140,0,662
18/6/2021,Sabah,3120,850,2954,18,36,54,4,39,43,430,61,1623
18/6/2021,Sarawak,3699,1001,3516,196,495,691,74,491,565,599,221,1884
18/6/2021,Selangor,5768,2210,5441,197,266,463,85,239,324,1386,474,2673
18/6/2021,Terengganu,1407,641,1367,9,16,25,4,19,23,123,31,681
18/6/2021,W.P. Kuala Lumpur,4198,1144,4013,13,118,131,5,87,92,853,88,1787
18/6/2021,W.P. Labuan,122,72,99,0,0,0,2,12,14,70,2,63
18/6/2021,W.P. Putrajaya,397,31,377,2,0,2,1,3,4,15,6,240
19/6/2021,Johor,5160,1485,4998,82,112,194,78,89,167,935,172,2855
19/6/2021,Kedah,2755,661,2639,5,30,35,0,24,24,345,5,1508
19/6/2021,Kelantan,2743,622,2547,6,69,75,2,54,56,450,15,1278
19/6/2021,Melaka,1101,290,1009,7,44,51,6,22,28,316,11,671
19/6/2021,Negeri Sembilan,1431,991,1362,5,141,146,3,88,91,845,9,533
19/6/2021,Pahang,2116,772,2041,0,12,12,0,10,10,93,1,727
19/6/2021,Perak,2728,448,2635,1,17,18,0,20,20,123,12,1601
19/6/2021,Perlis,487,87,471,5,0,5,0,0,0,18,12,243
19/6/2021,Pulau Pinang,1292,319,1232,0,9,9,0,16,16,121,0,644
19/6/2021,Sabah,3120,850,2954,18,65,83,13,47,60,428,64,1540
19/6/2021,Sarawak,3699,1001,3516,163,387,550,106,564,670,592,198,1818
19/6/2021,Selangor,5768,2210,5441,200,221,421,79,232,311,1358,473,2619
19/6/2021,Terengganu,1407,641,1367,5,12,17,6,24,30,113,26,666
19/6/2021,W.P. Kuala Lumpur,4198,1140,4013,17,73,90,7,99,106,820,88,1819
19/6/2021,W.P. Labuan,122,72,99,2,6,8,0,0,0,75,4,69
19/6/2021,W.P. Putrajaya,397,31,377,1,2,3,4,3,7,14,3,244
20/6/2021,Johor,5160,1485,4998,111,117,228,81,94,175,945,195,2947
20/6/2021,Kedah,2755,661,2639,2,34,36,0,36,36,337,6,1541
20/6/2021,Kelantan,2743,622,2547,7,63,70,2,67,69,446,20,1384
20/6/2021,Melaka,1101,290,1009,9,28,37,11,27,38,317,11,632
20/6/2021,Negeri Sembilan,1431,1084,1362,8,118,126,2,84,86,830,15,496
20/6/2021,Pahang,2250,842,2175,9,19,28,6,24,30,168,18,986
20/6/2021,Perak,2728,448,2635,3,21,24,1,12,13,133,11,1568
20/6/2021,Perlis,487,87,471,8,4,12,1,2,3,22,11,254
20/6/2021,Pulau Pinang,1292,319,1232,0,25,25,0,14,14,126,0,620
20/6/2021,Sabah,3120,850,2954,13,42,55,13,39,52,403,65,1471
20/6/2021,Sarawak,3699,1001,3516,132,308,440,127,427,554,578,183,1796
20/6/2021,Selangor,5768,2250,5441,125,292,417,81,228,309,1400,480,2558
20/6/2021,Terengganu,1407,641,1367,7,17,24,5,15,20,108,21,717
20/6/2021,W.P. Kuala Lumpur,4198,1140,4013,5,118,123,9,77,86,799,86,1723
20/6/2021,W.P. Labuan,122,72,99,0,0,0,0,10,10,63,4,66
20/6/2021,W.P. Putrajaya,397,25,377,1,3,4,0,4,4,13,4,213
21/6/2021,Johor,5160,1485,4998,112,120,232,94,105,199,935,209,2958
21/6/2021,Kedah,2755,661,2639,3,25,28,0,24,24,335,5,1561
21/6/2021,Kelantan,2743,622,2547,7,39,46,10,78,88,403,17,1371
21/6/2021,Melaka,1101,290,1009,3,27,30,7,23,30,318,7,633
21/6/2021,Negeri Sembilan,1431,1084,1362,10,131,141,9,93,102,832,16,501
21/6/2021,Pahang,2250,842,2175,2,34,36,6,30,36,169,16,972
21/6/2021,Perak,2728,448,2635,0,18,18,1,27,28,121,9,1645
21/6/2021,Perlis,487,87,471,5,0,5,0,3,3,19,12,250
21/6/2021,Pulau Pinang,1292,319,1232,0,12,12,0,22,22,115,0,640
21/6/2021,Sabah,3120,850,2954,18,39,57,20,32,52,402,62,1528
21/6/2021,Sarawak,3699,1001,3516,130,433,563,84,365,449,586,189,1847
21/6/2021,Selangor,5768,2250,5441,150,248,398,107,205,312,1415,492,2714
21/6/2021,Terengganu,1407,641,1367,8,12,20,5,26,31,99,30,733
21/6/2021,W.P. Kuala Lumpur,4198,1112,4013,10,87,97,5,68,73,828,78,1804
21/6/2021,W.P. Labuan,122,72,99,0,0,0,0,14,14,58,5,67
21/6/2021,W.P. Putrajaya,397,25,377,1,4,5,2,0,2,17,3,229
22/6/2021,Johor,5160,1485,4998,146,109,255,110,113,223,923,256,2976
22/6/2021,Kedah,2755,661,2639,2,37,39,0,37,37,335,2,1274
22/6/2021,Kelantan,2743,622,2547,4,47,51,6,56,62,387,14,1401
22/6/2021,Melaka,1101,290,1009,3,52,55,7,34,41,332,11,637
22/6/2021,Negeri Sembilan,1431,1084,1362,2,122,124,7,103,110,808,16,526
22/6/2021,Pahang,2250,842,2175,9,32,41,4,11,15,189,21,1000
22/6/2021,Perak,2728,448,2635,0,26,26,1,17,18,131,9,1694
22/6/2021,Perlis,487,87,471,9,2,11,1,1,2,18,12,258
22/6/2021,Pulau Pinang,1292,319,1232,0,17,17,0,13,13,118,0,668
22/6/2021,Sabah,3120,850,2954,29,47,76,17,41,58,382,65,1515
22/6/2021,Sarawak,3699,1001,3516,198,472,670,80,578,658,573,192,1887
22/6/2021,Selangor,5773,2262,5446,94,327,421,88,233,321,1422,466,2733
22/6/2021,Terengganu,1407,641,1367,9,5,14,9,6,15,98,31,814
22/6/2021,W.P. Kuala Lumpur,4436,1135,4231,8,123,131,4,65,69,892,75,1778
22/6/2021,W.P. Labuan,122,72,99,3,11,14,0,3,3,54,8,69
22/6/2021,W.P. Putrajaya,397,25,377,0,4,4,0,1,1,20,3,232
23/6/2021,Johor,5160,1485,4998,155,112,267,103,139,242,876,239,2962
23/6/2021,Kedah,2755,661,2639,0,30,30,0,33,33,315,1,1606
23/6/2021,Kelantan,2743,622,2547,8,41,49,4,68,72,360,18,1370
23/6/2021,Melaka,1101,290,1009,6,33,39,8,38,46,365,9,599
23/6/2021,Negeri Sembilan,1431,1084,1362,2,138,140,4,100,104,819,12,469
23/6/2021,Pahang,2250,842,2175,25,50,75,6,7,13,213,17,1025
23/6/2021,Perak,2728,448,2635,9,23,32,1,15,16,138,15,1743
23/6/2021,Perlis,487,87,471,16,1,17,2,2,4,17,19,260
23/6/2021,Pulau Pinang,1292,319,1232,0,16,16,0,18,18,116,0,683
23/6/2021,Sabah,3120,850,2954,18,38,56,17,43,60,370,59,1575
23/6/2021,Sarawak,3699,1001,3516,167,462,629,102,553,655,538,190,2007
23/6/2021,Selangor,6168,2262,5841,151,273,424,100,281,381,1408,507,2677
23/6/2021,Terengganu,1407,641,1367,6,20,26,7,16,23,101,30,718
23/6/2021,W.P. Kuala Lumpur,4436,1157,4231,7,147,154,9,111,120,886,80,1807
23/6/2021,W.P. Labuan,122,72,99,3,11,14,1,1,2,74,10,58
23/6/2021,W.P. Putrajaya,397,25,377,0,4,4,0,1,1,20,3,231
24/6/2021,Johor,5160,1545,4998,137,123,260,117,127,244,864,227,2971
24/6/2021,Kedah,2755,661,2639,1,29,30,0,67,67,300,1,1578
24/6/2021,Kelantan,2743,592,2547,12,43,55,17,75,92,329,13,1344
24/6/2021,Melaka,1101,290,1009,6,25,31,5,33,38,357,10,576
24/6/2021,Negeri Sembilan,1431,1084,1362,8,158,166,5,100,105,844,15,478
24/6/2021,Pahang,2250,842,2175,8,41,49,4,28,32,239,50,942
24/6/2021,Perak,2728,448,2635,1,30,31,2,11,13,153,10,1782
24/6/2021,Perlis,487,87,471,8,5,13,2,4,6,18,17,244
24/6/2021,Pulau Pinang,1292,319,1239,0,20,20,0,14,14,119,0,715
24/6/2021,Sabah,3120,850,2954,15,43,58,14,37,51,370,58,1596
24/6/2021,Sarawak,3699,1001,3516,134,417,551,93,408,501,527,175,1967
24/6/2021,Selangor,6168,2286,5829,181,296,477,128,232,360,1457,479,2669
24/6/2021,Terengganu,1331,565,1291,5,3,8,7,9,16,92,28,734
24/6/2021,W.P. Kuala Lumpur,4436,1157,4231,10,127,137,2,90,92,914,99,1740
24/6/2021,W.P. Labuan,122,72,99,0,4,4,2,2,4,76,6,67
24/6/2021,W.P. Putrajaya,397,25,377,2,1,3,2,3,5,17,4,244
25/6/2021,Johor,5160,1545,4998,124,81,205,88,100,188,830,181,2946
25/6/2021,Kedah,2755,661,2639,2,35,37,0,26,26,296,2,1580
25/6/2021,Kelantan,2743,584,2599,13,32,45,12,56,68,306,13,1265
25/6/2021,Melaka,1101,290,1009,0,36,36,0,26,26,367,10,592
25/6/2021,Negeri Sembilan,1431,1084,1362,5,149,154,10,86,96,873,10,504
25/6/2021,Pahang,2250,842,2175,4,39,43,5,26,31,251,47,950
25/6/2021,Perak,2728,399,2635,0,19,19,0,13,13,155,11,1730
25/6/2021,Perlis,487,87,471,6,0,6,1,4,5,14,15,259
25/6/2021,Pulau Pinang,1292,319,1237,0,18,18,0,15,15,122,0,693
25/6/2021,Sabah,3120,850,2954,16,37,53,13,42,55,354,57,1575
25/6/2021,Sarawak,3699,1001,3516,112,440,552,77,629,706,533,160,1905
25/6/2021,Selangor,6568,2310,6224,185,250,435,142,203,345,1562,453,2584
25/6/2021,Terengganu,1331,565,1291,5,1,6,7,13,20,74,26,755
25/6/2021,W.P. Kuala Lumpur,4436,1157,4231,8,69,77,1,47,48,438,13,1077
25/6/2021,W.P. Labuan,122,72,99,3,0,3,1,0,1,71,8,71
25/6/2021,W.P. Putrajaya,397,25,377,3,6,9,4,5,9,18,4,244
26/6/2021,Johor,5160,1545,4998,110,79,189,97,113,210,784,189,3009
26/6/2021,Kedah,2755,661,2639,1,31,32,0,34,34,297,2,1573
26/6/2021,Kelantan,2743,584,2599,13,29,42,4,46,50,289,23,1275
26/6/2021,Melaka,1101,290,1009,6,36,42,2,48,50,355,14,553
26/6/2021,Negeri Sembilan,1431,1084,1362,2,134,136,6,194,200,874,6,449
26/6/2021,Pahang,2250,842,2175,3,41,44,3,20,23,268,42,990
26/6/2021,Perak,2728,399,2635,2,23,25,0,13,13,168,14,1606
26/6/2021,Perlis,487,87,471,3,4,7,0,2,2,16,14,255
26/6/2021,Pulau Pinang,1292,319,1237,0,21,21,0,21,21,112,0,659
26/6/2021,Sabah,3120,850,2954,13,55,68,11,37,48,370,49,1464
26/6/2021,Sarawak,3699,1001,3516,143,417,560,114,383,497,545,162,1900
26/6/2021,Selangor,6568,2310,6224,135,245,380,97,260,357,1484,412,2465
26/6/2021,Terengganu,1331,565,1291,6,15,21,10,13,23,82,22,9
26/6/2021,W.P. Kuala Lumpur,4436,1161,4231,12,146,158,3,80,83,976,101,1652
26/6/2021,W.P. Labuan,122,72,99,6,8,14,1,0,1,72,13,71
26/6/2021,W.P. Putrajaya,397,25,377,0,0,0,0,6,6,12,4,257
27/6/2021,Johor,5160,1545,4998,94,97,191,102,77,179,774,202,2974
27/6/2021,Kedah,2755,661,2639,4,29,33,1,9,10,324,4,1652
27/6/2021,Kelantan,2743,584,2599,4,28,32,3,45,48,269,24,1372
27/6/2021,Melaka,1101,290,1009,8,48,56,7,34,41,369,15,560
27/6/2021,Negeri Sembilan,1431,1084,1362,3,132,135,1,101,102,861,8,451
27/6/2021,Pahang,2250,842,2175,5,46,51,5,9,14,301,42,881
27/6/2021,Perak,2728,399,2635,1,23,24,0,18,18,170,13,1626
27/6/2021,Perlis,487,87,471,6,0,6,1,0,1,16,14,263
27/6/2021,Pulau Pinang,1292,319,1237,0,21,21,0,15,15,116,0,626
27/6/2021,Sabah,3120,850,2954,13,19,32,11,15,26,181,46,1233
27/6/2021,Sarawak,3699,1001,3516,143,284,427,75,340,415,539,170,1795
27/6/2021,Selangor,6568,2420,6166,152,289,441,70,201,271,1578,472,2502
27/6/2021,Terengganu,1331,565,1291,14,10,24,7,12,19,80,29,691
27/6/2021,W.P. Kuala Lumpur,4436,1161,4231,17,118,135,5,85,90,1005,93,1675
27/6/2021,W.P. Labuan,122,72,99,2,3,5,1,1,2,76,14,64
27/6/2021,W.P. Putrajaya,397,25,377,0,1,1,1,3,4,10,3,253
28/6/2021,Johor,5160,1545,4998,122,76,198,87,119,206,711,188,3041
28/6/2021,Kedah,2755,661,2639,1,25,26,0,39,39,309,1,1673
28/6/2021,Kelantan,2743,565,2599,4,54,58,9,40,49,280,19,1427
28/6/2021,Melaka,1101,290,1009,6,38,44,9,33,42,374,12,557
28/6/2021,Negeri Sembilan,1431,1084,1366,8,126,134,3,103,106,846,13,465
28/6/2021,Pahang,2250,842,2175,6,26,32,6,6,12,316,44,927
28/6/2021,Perak,2728,399,2635,0,24,24,0,19,19,169,17,1632
28/6/2021,Perlis,487,87,471,10,5,15,0,0,0,21,19,265
28/6/2021,Pulau Pinang,1292,319,1232,0,17,17,0,13,13,121,0,634
28/6/2021,Sabah,3120,850,2954,9,51,60,8,35,43,373,55,1368
28/6/2021,Sarawak,3699,1001,3516,158,408,566,75,504,579,535,195,1808
28/6/2021,Selangor,6568,2456,6166,98,295,393,159,203,362,1682,413,2266
28/6/2021,Terengganu,1331,565,1291,4,18,22,6,19,25,79,27,714
28/6/2021,W.P. Kuala Lumpur,4436,1192,4241,13,118,131,6,81,87,1038,98,1721
28/6/2021,W.P. Labuan,122,106,95,0,0,0,0,0,0,57,12,77
28/6/2021,W.P. Putrajaya,397,25,377,4,5,9,0,1,1,14,8,257
29/6/2021,Johor,5160,1545,4973,133,115,248,97,101,198,713,186,3085
29/6/2021,Kedah,2755,661,2639,3,45,48,0,30,30,320,3,1673
29/6/2021,Kelantan,2737,559,2593,13,41,54,9,44,53,278,23,1483
29/6/2021,Melaka,1101,290,987,8,32,40,5,32,37,374,15,546
29/6/2021,Negeri Sembilan,1431,1084,1366,4,129,133,5,110,115,827,7,518
29/6/2021,Pahang,2250,842,2175,6,34,40,4,16,20,353,50,913
29/6/2021,Perak,2728,399,2635,4,22,26,5,16,21,176,11,1691
29/6/2021,Perlis,487,87,471,3,0,3,0,3,3,18,13,265
29/6/2021,Pulau Pinang,1292,319,1232,0,28,28,0,16,16,124,0,730
29/6/2021,Sabah,3120,850,2954,9,79,88,6,41,47,395,45,1528
29/6/2021,Sarawak,3699,1001,3516,145,275,420,103,587,690,508,171,1917
29/6/2021,Selangor,6568,2456,6166,130,295,425,79,248,327,1724,390,2461
29/6/2021,Terengganu,1481,565,1425,2,7,9,1,9,10,77,28,754
29/6/2021,W.P. Kuala Lumpur,4436,1192,4240,8,109,117,8,87,95,1055,83,1929
29/6/2021,W.P. Labuan,122,106,99,0,7,7,1,40,41,60,3,75
29/6/2021,W.P. Putrajaya,397,25,377,4,5,9,0,3,3,12,8,256
30/6/2021,Johor,5160,1545,4973,122,103,225,95,77,172,573,152,2400
30/6/2021,Kedah,2755,661,2639,1,44,45,0,35,35,324,2,1685
30/6/2021,Kelantan,2737,559,2593,10,49,59,15,46,61,283,19,1483
30/6/2021,Melaka,1101,290,987,10,41,51,10,34,44,381,15,546
30/6/2021,Negeri Sembilan,1431,1084,1366,8,129,137,11,94,105,843,10,498
30/6/2021,Pahang,2250,842,2175,11,90,101,9,32,41,391,46,955
30/6/2021,Perak,2728,399,2635,0,11,11,0,21,21,164,9,1727
30/6/2021,Perlis,487,87,471,4,5,9,0,1,1,22,12,256
30/6/2021,Pulau Pinang,1292,319,1232,0,28,28,0,7,7,144,0,721
30/6/2021,Sabah,3120,834,2954,23,41,64,16,42,58,374,52,1590
30/6/2021,Sarawak,3699,1001,3516,86,174,260,90,400,490,496,172,1914
30/6/2021,Selangor,6568,2458,6164,118,301,419,73,267,340,1753,389,2435
30/6/2021,Terengganu,1481,565,1425,4,4,8,17,37,54,43,11,791
30/6/2021,W.P. Kuala Lumpur,4436,1216,4240,18,115,133,9,103,112,1065,86,1869
30/6/2021,W.P. Labuan,122,106,99,0,0,0,0,37,37,63,3,74
30/6/2021,W.P. Putrajaya,397,25,377,2,4,6,3,3,6,13,7,269
1/7/2021,Johor,5090,1535,4903,178,131,309,130,117,247,732,233,3051
1/7/2021,Kedah,2755,661,2639,1,70,71,0,32,32,338,2,1650
1/7/2021,Kelantan,2737,559,2593,13,59,72,14,49,63,297,18,1439
1/7/2021,Melaka,1101,290,987,18,56,74,10,40,50,397,23,579
1/7/2021,Negeri Sembilan,1431,1084,1366,6,147,153,4,96,100,861,12,456
1/7/2021,Pahang,2250,842,2175,9,66,75,13,35,48,395,38,956
1/7/2021,Perak,2728,399,2635,0,19,19,1,24,25,148,8,1731
1/7/2021,Perlis,487,87,471,4,1,5,2,0,2,23,15,233
1/7/2021,Pulau Pinang,1292,319,1232,0,32,32,0,17,17,149,0,709
1/7/2021,Sabah,3120,834,2954,7,29,36,15,45,60,337,45,1564
1/7/2021,Sarawak,3699,1001,3516,105,287,392,79,458,537,483,160,1794
1/7/2021,Selangor,6568,2499,6164,126,335,461,92,287,379,1770,336,2487
1/7/2021,Terengganu,1481,565,1425,3,6,9,5,4,9,44,9,785
1/7/2021,W.P. Kuala Lumpur,4436,1216,4240,18,113,131,6,104,110,1077,82,1833
1/7/2021,W.P. Labuan,122,106,99,4,29,33,4,30,34,62,4,82
1/7/2021,W.P. Putrajaya,397,25,377,1,5,6,4,4,8,14,4,286
2/7/2021,Johor,5160,1545,4973,117,112,229,101,76,177,750,189,3036
2/7/2021,Kedah,2755,661,2639,1,60,61,1,31,32,356,3,1563
2/7/2021,Kelantan,2737,559,2593,8,27,35,10,35,45,286,16,1333
2/7/2021,Melaka,1101,290,987,7,26,33,8,28,36,406,22,584
2/7/2021,Negeri Sembilan,1431,1084,1366,10,163,173,3,105,108,881,16,538
2/7/2021,Pahang,2250,842,2175,11,61,72,17,52,69,425,29,1006
2/7/2021,Perak,2728,399,2653,1,21,22,0,30,30,136,7,1728
2/7/2021,Perlis,487,87,471,3,0,3,0,1,1,22,12,228
2/7/2021,Pulau Pinang,1304,258,1244,0,32,32,0,15,15,172,0,749
2/7/2021,Sabah,3120,834,2954,12,33,45,10,32,42,337,45,1461
2/7/2021,Sarawak,3699,1001,3516,106,241,347,88,479,567,474,138,1783
2/7/2021,Selangor,6568,2538,6164,131,440,571,103,322,425,1886,386,2421
2/7/2021,Terengganu,1481,565,1425,5,1,6,2,3,5,42,12,711
2/7/2021,W.P. Kuala Lumpur,4436,1235,4240,16,159,175,10,104,114,1115,72,1815
2/7/2021,W.P. Labuan,122,106,99,0,0,0,1,0,1,58,3,69
2/7/2021,W.P. Putrajaya,397,26,377,4,8,12,0,2,2,20,6,289
3/7/2021,Johor,5160,1545,4973,140,111,251,88,94,182,743,185,2926
3/7/2021,Kedah,2755,661,2639,0,45,45,0,28,28,373,1,1575
3/7/2021,Kelantan,2737,541,2593,11,44,55,6,39,45,284,20,1289
3/7/2021,Melaka,1101,290,987,9,26,35,9,28,37,406,20,587
3/7/2021,Negeri Sembilan,1431,1084,1366,3,142,145,7,117,124,887,12,500
3/7/2021,Pahang,2250,842,2175,10,59,69,3,34,37,441,36,867
3/7/2021,Perak,2728,399,2645,2,26,28,1,14,15,145,23,1619
3/7/2021,Perlis,487,87,471,6,3,9,0,1,1,24,15,236
3/7/2021,Pulau Pinang,1304,258,1244,0,28,28,0,23,23,170,0,709
3/7/2021,Sabah,3120,834,2954,11,34,45,11,35,46,328,49,1436
3/7/2021,Sarawak,3699,1001,3516,81,323,404,120,457,577,469,138,1634
3/7/2021,Selangor,6568,2651,6164,158,406,564,157,306,463,2013,353,2370
3/7/2021,Terengganu,1481,565,1425,2,7,9,5,5,10,44,10,803
3/7/2021,W.P. Kuala Lumpur,4436,1260,4240,8,112,120,8,93,101,1104,82,1720
3/7/2021,W.P. Labuan,122,106,99,0,0,0,1,3,4,53,2,69
3/7/2021,W.P. Putrajaya,397,35,377,4,10,14,0,5,5,25,10,286
4/7/2021,Johor,5160,1545,4973,112,59,171,61,62,123,742,220,3035
4/7/2021,Kedah,2755,661,2639,0,55,55,0,28,28,385,1,1698
4/7/2021,Kelantan,2737,541,2593,8,38,46,7,36,43,293,21,1433
4/7/2021,Melaka,1101,290,987,4,40,44,11,24,35,414,14,583
4/7/2021,Negeri Sembilan,1745,1084,1661,4,150,154,5,90,95,914,11,490
4/7/2021,Pahang,2250,842,2175,6,28,34,4,27,31,454,38,868
4/7/2021,Perak,2728,399,2645,1,19,20,0,22,22,134,18,1602
4/7/2021,Perlis,487,87,471,6,0,6,0,3,3,21,18,250
4/7/2021,Pulau Pinang,1304,258,1244,0,27,27,0,22,22,180,0,702
4/7/2021,Sabah,3120,834,2954,27,55,82,13,32,45,342,61,1519
4/7/2021,Sarawak,3699,1001,3516,87,188,275,86,324,410,440,131,1739
4/7/2021,Selangor,6568,2704,6164,101,428,529,97,249,346,2164,348,2332
4/7/2021,Terengganu,1481,565,1425,5,17,22,5,5,10,56,10,772
4/7/2021,W.P. Kuala Lumpur,4436,1267,4237,13,140,153,5,86,91,1140,77,1676
4/7/2021,W.P. Labuan,122,106,99,7,6,13,0,7,7,51,9,70
4/7/2021,W.P. Putrajaya,397,41,377,5,9,14,3,5,8,29,12,242
5/7/2021,Johor,5160,1545,4973,119,95,214,86,101,187,730,229,3043
5/7/2021,Kedah,2755,661,2639,3,64,67,0,24,24,404,4,1641
5/7/2021,Kelantan,2737,541,2593,7,34,41,13,39,52,288,16,1475
5/7/2021,Melaka,1101,444,987,3,54,57,5,33,38,416,12,615
5/7/2021,Negeri Sembilan,1745,1084,1658,4,112,116,5,101,106,898,10,470
5/7/2021,Pahang,2250,842,2175,7,39,46,7,56,63,429,32,920
5/7/2021,Perak,2728,399,2645,2,30,32,0,14,14,153,21,1651
5/7/2021,Perlis,487,87,471,6,0,6,1,2,3,19,18,268
5/7/2021,Pulau Pinang,1304,258,1244,0,31,31,0,19,19,189,0,743
5/7/2021,Sabah,3120,834,2954,20,37,57,11,27,38,349,69,1575
5/7/2021,Sarawak,3699,1001,3516,97,245,342,65,320,385,444,143,1682
5/7/2021,Selangor,6568,2731,6164,104,353,457,89,267,356,2209,343,2362
5/7/2021,Terengganu,1481,565,1425,0,12,12,6,1,7,67,4,855
5/7/2021,W.P. Kuala Lumpur,4436,1278,4237,10,124,134,5,100,105,1133,74,1635
5/7/2021,W.P. Labuan,122,106,99,4,5,9,1,10,11,45,12,72
5/7/2021,W.P. Putrajaya,397,41,377,5,9,14,3,5,8,29,12,273
6/7/2021,Johor,5160,1545,4973,158,117,275,114,101,215,729,278,3069
6/7/2021,Kedah,2755,661,2639,3,81,84,0,22,22,438,5,1660
6/7/2021,Kelantan,2737,541,2593,7,34,41,7,38,45,281,15,1523
6/7/2021,Melaka,1101,444,987,3,37,40,5,34,39,419,10,599
6/7/2021,Negeri Sembilan,1745,1084,1658,4,141,145,3,127,130,861,7,512
6/7/2021,Pahang,2250,842,2175,9,48,57,5,31,36,444,50,880
6/7/2021,Perak,2728,399,2645,1,32,33,3,20,23,165,16,1680
6/7/2021,Perlis,487,87,471,6,0,6,8,3,11,16,10,293
6/7/2021,Pulau Pinang,1304,244,1244,0,26,26,0,20,20,183,0,756
6/7/2021,Sabah,3120,834,2954,13,30,43,17,29,46,336,59,1559
6/7/2021,Sarawak,3699,1001,3516,103,342,445,71,326,397,444,156,1672
6/7/2021,Selangor,6568,2813,6164,125,361,486,77,273,350,2310,307,2370
6/7/2021,Terengganu,1481,565,1425,5,7,12,0,7,7,67,9,879
6/7/2021,W.P. Kuala Lumpur,4436,1313,4237,15,142,157,7,126,133,1188,72,1623
6/7/2021,W.P. Labuan,122,106,99,0,10,10,0,2,2,52,5,85
6/7/2021,W.P. Putrajaya,397,56,377,3,9,12,1,3,4,38,11,284
7/7/2021,Johor,5160,1521,4973,122,88,210,120,110,230,722,237,3047
7/7/2021,Kedah,2755,601,2630,1,80,81,1,26,27,468,4,1641
7/7/2021,Kelantan,2737,541,2593,7,39,46,11,26,37,294,12,1517
7/7/2021,Melaka,1101,444,987,4,26,30,2,37,39,406,14,609
7/7/2021,Negeri Sembilan,1745,1084,1658,5,176,181,6,113,119,901,13,501
7/7/2021,Pahang,2250,842,2175,36,45,81,6,38,44,428,39,898
7/7/2021,Perak,2728,399,2645,0,22,22,1,18,19,165,19,1737
7/7/2021,Perlis,487,87,471,3,4,7,0,5,5,15,6,276
7/7/2021,Pulau Pinang,1304,244,1244,0,37,37,0,21,21,198,0,717
7/7/2021,Sabah,3120,834,2954,11,50,61,15,33,48,350,51,1561
7/7/2021,Sarawak,3699,1001,3516,105,228,333,80,285,365,430,103,1760
7/7/2021,Selangor,6568,2902,6164,116,397,513,93,329,422,2353,369,2325
7/7/2021,Terengganu,1481,565,1425,5,14,19,7,6,13,75,7,814
7/7/2021,W.P. Kuala Lumpur,4436,1343,4237,9,185,194,5,121,126,1224,63,1619
7/7/2021,W.P. Labuan,122,106,99,0,4,4,0,4,4,52,5,88
7/7/2021,W.P. Putrajaya,397,56,377,9,11,20,9,7,16,42,11,281
8/7/2021,Johor,5160,1521,4973,159,132,291,122,102,224,731,255,3017
8/7/2021,Kedah,2755,601,2630,4,69,73,0,48,48,434,6,1616
8/7/2021,Kelantan,2737,541,2593,8,38,46,10,59,69,270,11,1482
8/7/2021,Melaka,1101,444,987,15,40,55,5,28,33,392,24,630
8/7/2021,Negeri Sembilan,1745,1084,1658,4,140,144,8,121,129,882,9,493
8/7/2021,Pahang,2250,842,2175,19,32,51,10,44,54,429,42,1001
8/7/2021,Perak,2728,399,2645,4,36,40,0,18,18,185,21,1696
8/7/2021,Perlis,487,87,471,9,0,9,1,3,4,12,13,274
8/7/2021,Pulau Pinang,1304,244,1244,0,34,34,0,24,24,197,0,708
8/7/2021,Sabah,3120,834,2954,12,31,43,16,43,59,326,47,1583
8/7/2021,Sarawak,3699,1001,3516,92,183,275,118,380,498,427,135,1790
8/7/2021,Selangor,6568,2929,6164,102,470,572,82,381,463,2420,327,2157
8/7/2021,Terengganu,1481,565,1425,8,9,17,4,4,8,80,10,805
8/7/2021,W.P. Kuala Lumpur,4436,1397,4237,14,181,195,7,120,127,1270,64,1639
8/7/2021,W.P. Labuan,122,106,99,8,0,8,1,2,3,50,12,71
8/7/2021,W.P. Putrajaya,397,76,377,1,29,30,6,8,14,66,10,286
9/7/2021,Johor,5160,1521,4973,136,154,290,85,102,187,757,242,2855
9/7/2021,Kedah,2755,601,2630,8,77,85,1,41,42,453,9,1535
9/7/2021,Kelantan,2737,513,2593,10,47,57,12,52,64,267,9,1381
9/7/2021,Melaka,1101,444,987,8,42,50,7,29,36,405,23,607
9/7/2021,Negeri Sembilan,1745,1084,1658,3,119,122,1,131,132,833,11,567
9/7/2021,Pahang,2250,842,2175,9,31,40,6,46,52,427,46,899
9/7/2021,Perak,2728,399,2645,1,44,45,0,13,13,206,18,1697
9/7/2021,Perlis,487,87,471,4,1,5,0,4,4,9,9,268
9/7/2021,Pulau Pinang,1304,244,1244,0,27,27,0,24,24,194,0,736
9/7/2021,Sabah,3120,834,2954,18,32,50,16,31,47,332,50,1594
9/7/2021,Sarawak,3699,1001,3516,98,194,292,57,259,316,450,134,1776
9/7/2021,Selangor,6568,2976,6164,90,493,583,72,330,402,2527,320,2180
9/7/2021,Terengganu,1481,565,1425,11,10,21,8,5,13,82,13,733
9/7/2021,W.P. Kuala Lumpur,4436,1435,4231,14,162,176,5,114,119,1293,68,1724
9/7/2021,W.P. Labuan,122,106,99,0,12,12,0,1,1,60,4,73
9/7/2021,W.P. Putrajaya,397,94,377,8,22,30,4,7,11,80,14,214
10/7/2021,Johor,5160,1521,4973,123,137,260,102,79,181,833,243,2843
10/7/2021,Kedah,2755,601,2630,9,69,78,0,39,39,469,9,1560
10/7/2021,Kelantan,2737,513,2593,12,43,55,2,32,34,275,19,1306
10/7/2021,Melaka,1101,444,987,10,42,52,15,29,44,405,18,553
10/7/2021,Negeri Sembilan,1745,1084,1658,4,142,146,7,99,106,829,8,558
10/7/2021,Pahang,2250,842,2175,48,42,90,15,54,69,392,77,880
10/7/2021,Perak,2728,399,2645,0,25,25,1,21,22,198,22,1604
10/7/2021,Perlis,487,87,471,7,1,8,0,0,0,10,14,246
10/7/2021,Pulau Pinang,1304,244,1244,0,29,29,0,21,21,195,0,691
10/7/2021,Sabah,3120,834,2954,12,26,38,9,21,30,333,52,1529
10/7/2021,Sarawak,3699,1001,3520,108,210,318,53,326,379,428,152,1799
10/7/2021,Selangor,6568,3051,6164,130,495,625,116,425,541,2541,303,2046
10/7/2021,Terengganu,1481,565,1425,8,8,16,3,5,8,84,18,667
10/7/2021,W.P. Kuala Lumpur,4436,1477,4231,22,158,180,5,128,133,1262,66,1502
10/7/2021,W.P. Labuan,122,106,99,0,0,0,1,1,2,49,2,76
10/7/2021,W.P. Putrajaya,397,94,377,7,15,22,6,19,25,76,15,191
11/7/2021,Johor,5160,1521,4973,97,152,249,104,78,182,900,193,2884
11/7/2021,Kedah,2755,622,2630,5,71,76,0,28,28,500,8,1604
11/7/2021,Kelantan,2737,513,2593,16,34,50,7,46,53,264,28,1398
11/7/2021,Melaka,1101,444,987,3,38,41,7,31,38,428,15,530
11/7/2021,Negeri Sembilan,1745,1084,1658,4,128,132,5,98,103,825,7,523
11/7/2021,Pahang,2250,842,2175,13,66,79,10,41,51,443,49,766
11/7/2021,Perak,2728,399,2645,2,42,44,3,26,29,205,19,1567
11/7/2021,Perlis,487,87,471,3,4,7,0,3,3,12,13,267
11/7/2021,Pulau Pinang,1304,244,1244,0,43,43,0,22,22,205,0,631
11/7/2021,Sabah,3120,834,2954,13,24,37,12,27,39,332,51,1445
11/7/2021,Sarawak,3699,1001,3520,89,304,393,90,279,369,399,152,1692
11/7/2021,Selangor,6568,3057,6164,86,470,556,45,315,360,2621,294,1927
11/7/2021,Terengganu,1481,565,1425,4,15,19,8,8,16,90,14,733
11/7/2021,W.P. Kuala Lumpur,4436,1571,4231,5,163,168,7,104,111,1350,60,1408
11/7/2021,W.P. Labuan,122,106,99,0,11,11,0,4,4,55,2,73
11/7/2021,W.P. Putrajaya,397,110,377,21,14,35,5,10,15,80,31,174
12/7/2021,Johor,5160,1521,4973,161,133,294,93,142,235,860,249,2919
12/7/2021,Kedah,2664,595,2539,4,77,81,0,18,18,540,4,1489
12/7/2021,Kelantan,2737,513,2593,15,55,70,21,34,55,282,22,1490
12/7/2021,Melaka,1307,464,1186,11,52,63,4,45,49,426,22,536
12/7/2021,Negeri Sembilan,1749,1086,1662,7,158,165,1,107,108,843,11,496
12/7/2021,Pahang,2250,842,2175,6,50,56,19,51,70,411,63,883
12/7/2021,Perak,2728,399,2645,0,28,28,2,20,22,204,14,1621
12/7/2021,Perlis,487,87,471,4,1,5,0,0,0,13,14,269
12/7/2021,Pulau Pinang,1304,244,1237,0,34,34,0,20,20,214,0,644
12/7/2021,Sabah,3120,834,2954,13,58,71,15,23,38,365,51,1508
12/7/2021,Sarawak,3699,1001,3520,76,212,288,68,265,333,440,162,1724
12/7/2021,Selangor,6568,3086,6155,77,361,438,71,278,349,2645,303,1986
12/7/2021,Terengganu,1481,565,1425,4,22,26,7,24,31,88,11,738
12/7/2021,W.P. Kuala Lumpur,4436,1571,4231,5,173,178,3,110,113,1378,68,1446
12/7/2021,W.P. Labuan,122,106,99,3,0,3,0,0,0,51,5,75
12/7/2021,W.P. Putrajaya,397,112,377,4,24,28,9,14,23,97,30,156
13/7/2021,Johor,5160,1521,4973,170,154,324,114,138,252,900,229,3033
13/7/2021,Kedah,2664,595,2539,3,79,82,0,34,34,543,4,1469
13/7/2021,Kelantan,2737,513,2593,13,40,53,11,55,66,263,24,1485
13/7/2021,Melaka,1307,464,1171,10,56,66,2,34,36,448,30,531
13/7/2021,Negeri Sembilan,1749,1086,1662,5,161,166,0,113,113,854,16,507
13/7/2021,Pahang,2250,842,2175,14,81,95,14,66,80,419,64,906
13/7/2021,Perak,2728,399,2645,0,30,30,0,21,21,194,20,1676
13/7/2021,Perlis,487,87,471,2,0,2,1,3,4,10,11,291
13/7/2021,Pulau Pinang,1304,244,1237,0,40,40,0,16,16,228,0,627
13/7/2021,Sabah,3120,834,2954,7,42,49,9,36,45,360,51,1660
13/7/2021,Sarawak,3699,1001,3520,115,205,320,58,222,280,413,168,1773
13/7/2021,Selangor,6568,3155,6151,108,428,536,80,367,447,2693,246,2033
13/7/2021,Terengganu,1481,565,1425,5,8,13,3,9,12,86,13,775
13/7/2021,W.P. Kuala Lumpur,4436,1571,4223,12,180,192,1,127,128,1438,61,1477
13/7/2021,W.P. Labuan,122,106,99,0,0,0,1,8,9,30,2,78
13/7/2021,W.P. Putrajaya,397,112,377,3,17,20,11,11,22,96,18,120
14/7/2021,Johor,5160,1521,4973,129,139,268,96,113,209,925,211,3045
14/7/2021,Kedah,2664,648,2539,4,89,93,0,35,35,551,4,1459
14/7/2021,Kelantan,2737,533,2593,17,62,79,10,34,44,293,31,1445
14/7/2021,Melaka,1307,464,1171,0,43,43,17,44,61,449,13,544
14/7/2021,Negeri Sembilan,1749,1086,1658,7,161,168,4,102,106,868,19,532
14/7/2021,Pahang,2250,842,2175,14,54,68,9,50,59,422,68,1016
14/7/2021,Perak,2728,399,2645,1,47,48,3,13,16,226,16,1735
14/7/2021,Perlis,487,87,471,4,0,4,4,1,5,9,11,281
14/7/2021,Pulau Pinang,1304,244,1236,0,34,34,0,14,14,239,0,739
14/7/2021,Sabah,3120,834,2954,19,41,60,12,34,46,365,59,1654
14/7/2021,Sarawak,3699,997,3520,78,288,366,73,214,287,390,165,1800
14/7/2021,Selangor,6568,3065,6145,3,600,603,0,370,370,3043,261,1799
14/7/2021,Terengganu,1481,565,1425,11,13,24,8,10,18,89,16,767
14/7/2021,W.P. Kuala Lumpur,4436,1579,4223,3,161,164,3,120,123,1312,35,1422
14/7/2021,W.P. Labuan,122,106,99,0,0,0,0,1,1,35,1,75
14/7/2021,W.P. Putrajaya,397,112,377,4,29,33,2,21,23,104,8,186
15/7/2021,Johor,5160,1521,4973,131,154,285,90,111,201,952,222,2931
15/7/2021,Kedah,2664,648,2539,4,83,87,0,36,36,577,3,1404
15/7/2021,Kelantan,2737,533,2593,23,69,92,19,61,80,298,35,972
15/7/2021,Melaka,1307,464,1171,13,67,80,12,28,40,486,35,600
15/7/2021,Negeri Sembilan,1749,1086,1658,5,166,171,6,105,111,904,15,531
15/7/2021,Pahang,2250,842,2182,25,60,85,10,36,46,441,83,937
15/7/2021,Perak,2728,399,2645,2,51,53,3,23,26,250,16,1744
15/7/2021,Perlis,487,87,471,7,5,12,0,0,0,14,11,291
15/7/2021,Pulau Pinang,1304,275,1232,0,39,39,0,27,27,242,0,740
15/7/2021,Sabah,3120,834,2954,12,32,44,15,29,44,364,58,1584
15/7/2021,Sarawak,3699,997,3520,108,183,291,84,231,315,371,159,1801
15/7/2021,Selangor,6568,3156,6143,96,500,596,67,363,430,3082,266,1679
15/7/2021,Terengganu,1481,565,1425,4,13,17,8,7,15,94,12,710
15/7/2021,W.P. Kuala Lumpur,4436,1452,4224,3,173,176,3,149,152,1404,42,1395
15/7/2021,W.P. Labuan,122,106,99,1,2,3,0,5,5,23,2,85
15/7/2021,W.P. Putrajaya,397,112,377,4,29,33,2,21,23,104,20,186
16/7/2021,Johor,5160,1521,4973,151,177,328,106,111,217,999,222,2817
16/7/2021,Kedah,2664,648,2539,3,89,92,0,43,43,586,3,1418
16/7/2021,Kelantan,2737,533,2593,18,54,72,12,33,45,318,41,1238
16/7/2021,Melaka,1307,514,1171,6,43,49,10,35,45,494,31,626
16/7/2021,Negeri Sembilan,1749,1086,1658,12,160,172,3,124,127,908,25,521
16/7/2021,Pahang,2250,842,2182,14,56,70,17,34,51,463,81,881
16/7/2021,Perak,2728,399,2645,5,53,58,0,29,29,255,25,1705
16/7/2021,Perlis,487,87,471,9,7,16,3,1,4,20,10,278
16/7/2021,Pulau Pinang,1304,275,1244,0,41,41,0,26,26,248,0,770
16/7/2021,Sabah,3120,834,2954,19,48,67,16,33,49,355,59,1659
16/7/2021,Sarawak,4037,1279,3831,97,177,274,90,238,328,384,317,1829
16/7/2021,Selangor,6452,3336,6027,142,361,503,72,206,278,3163,261,1787
16/7/2021,Terengganu,1481,565,1425,9,16,25,6,19,25,90,15,748
16/7/2021,W.P. Kuala Lumpur,4436,1506,4224,4,191,195,4,153,157,1592,46,841
16/7/2021,W.P. Labuan,122,106,99,2,0,2,0,1,1,23,4,78
16/7/2021,W.P. Putrajaya,397,132,377,0,16,16,0,10,10,102,0,119
17/7/2021,Johor,5160,1521,4973,158,128,286,87,110,197,1026,231,2786
17/7/2021,Kedah,2664,648,2539,1,83,84,0,43,43,594,6,1405
17/7/2021,Kelantan,2737,533,2593,17,57,74,9,47,56,321,49,1222
17/7/2021,Melaka,1307,514,1161,7,76,83,6,47,53,473,32,617
17/7/2021,Negeri Sembilan,1749,1086,1658,4,175,179,13,119,132,929,16,468
17/7/2021,Pahang,2250,842,2182,9,70,79,19,49,68,475,69,864
17/7/2021,Perak,2728,399,2645,4,63,67,1,31,32,302,0,1623
17/7/2021,Perlis,487,87,471,5,1,6,0,0,0,21,13,265
17/7/2021,Pulau Pinang,1304,312,1244,0,55,55,0,26,26,272,0,732
17/7/2021,Sabah,3120,834,2954,24,68,92,9,35,44,388,71,1553
17/7/2021,Sarawak,4037,1279,3831,84,302,386,74,292,366,295,297,1552
17/7/2021,Selangor,6452,3375,6027,97,445,542,59,261,320,3301,273,1736
17/7/2021,Terengganu,1481,565,1425,13,21,34,6,5,11,104,23,674
17/7/2021,W.P. Kuala Lumpur,4436,1506,4224,0,210,210,1,158,159,1463,46,1207
17/7/2021,W.P. Labuan,122,106,99,0,0,0,0,0,0,19,2,80
17/7/2021,W.P. Putrajaya,397,132,377,0,14,14,0,16,16,97,0,118
18/7/2021,Johor,5160,1521,4973,131,150,281,87,118,205,1042,210,2919
18/7/2021,Kedah,2664,648,2539,5,97,102,0,41,41,622,12,1408
18/7/2021,Kelantan,2737,541,2593,7,41,48,12,33,45,333,44,1332
18/7/2021,Melaka,1307,514,1161,23,74,97,4,48,52,499,22,594
18/7/2021,Negeri Sembilan,1749,1086,1658,7,154,161,4,107,111,935,19,428
18/7/2021,Pahang,2250,842,2182,30,39,69,26,30,56,327,241,824
18/7/2021,Perak,2728,399,2645,3,53,56,2,32,34,314,0,1574
18/7/2021,Perlis,487,87,471,14,3,17,1,0,1,24,19,255
18/7/2021,Pulau Pinang,1304,312,1244,0,48,48,0,22,22,294,0,680
18/7/2021,Sabah,3120,834,2954,15,76,91,23,30,53,407,63,1223
18/7/2021,Sarawak,4037,1279,3831,76,207,283,79,349,428,370,283,1785
18/7/2021,Selangor,6452,3391,6027,61,470,531,38,338,376,3441,259,1730
18/7/2021,Terengganu,1481,565,1425,6,20,26,10,11,21,113,18,742
18/7/2021,W.P. Kuala Lumpur,4436,1656,4224,3,259,262,1,128,129,1535,49,1207
18/7/2021,W.P. Labuan,122,106,99,2,2,4,1,4,5,18,3,74
18/7/2021,W.P. Putrajaya,397,132,377,0,26,26,0,22,22,104,0,174
19/7/2021,Johor,5160,1521,4973,143,152,295,114,130,244,1083,202,2941
19/7/2021,Kedah,2664,744,2539,5,108,113,0,40,40,682,5,1389
19/7/2021,Kelantan,2737,541,2593,9,45,54,18,39,57,337,35,1325
19/7/2021,Melaka,1307,514,1173,1,65,66,0,17,17,551,35,611
19/7/2021,Negeri Sembilan,1749,1086,1658,8,178,186,6,107,113,959,21,453
19/7/2021,Pahang,2250,842,2182,9,60,69,20,47,67,509,59,739
19/7/2021,Perak,2728,399,2645,0,64,64,1,23,24,341,0,1526
19/7/2021,Perlis,487,87,471,7,2,9,1,3,4,23,18,258
19/7/2021,Pulau Pinang,1304,312,1244,0,31,31,0,34,34,294,0,725
19/7/2021,Sabah,3120,834,2954,14,58,72,17,39,56,410,62,1552
19/7/2021,Sarawak,4037,1279,3831,73,256,329,51,230,281,429,309,1768
19/7/2021,Selangor,6452,3391,6027,45,310,355,44,164,208,3704,357,1899
19/7/2021,Terengganu,1481,565,1425,12,25,37,12,17,29,118,21,762
19/7/2021,W.P. Kuala Lumpur,4436,1656,4224,7,237,244,2,189,191,1809,61,1280
19/7/2021,W.P. Labuan,122,106,99,1,6,7,0,3,3,20,4,66
19/7/2021,W.P. Putrajaya,385,112,365,0,23,23,0,14,14,106,0,173
20/7/2021,Johor,5160,1521,4973,175,175,350,112,146,258,1121,235,2762
20/7/2021,Kedah,2664,744,2539,3,115,118,0,59,59,708,13,1533
20/7/2021,Kelantan,2737,541,2593,16,52,68,23,55,78,331,28,1194
20/7/2021,Melaka,1307,580,1173,7,50,57,10,48,58,553,35,536
20/7/2021,Negeri Sembilan,1749,1086,1658,7,151,158,12,153,165,926,16,474
20/7/2021,Pahang,2250,842,2182,10,68,78,18,67,85,504,56,701
20/7/2021,Perak,2728,399,2645,0,50,50,2,35,37,325,0,1469
20/7/2021,Perlis,487,87,471,4,2,6,1,2,3,23,18,230
20/7/2021,Pulau Pinang,1304,312,1244,0,34,34,0,41,41,288,0,713
20/7/2021,Sabah,3120,834,2954,15,107,122,5,30,35,444,70,1534
20/7/2021,Sarawak,4037,1279,3831,75,168,243,56,162,218,346,291,1802
20/7/2021,Selangor,6452,3391,6027,79,426,505,236,485,721,3421,214,2191
20/7/2021,Terengganu,1481,565,1425,12,24,36,8,4,12,135,28,667
20/7/2021,W.P. Kuala Lumpur,3976,1656,3764,1,206,207,0,198,198,1742,58,756
20/7/2021,W.P. Labuan,122,106,99,1,2,3,1,1,2,18,4,71
20/7/2021,W.P. Putrajaya,385,112,365,1,28,29,2,25,27,112,0,192
21/7/2021,Johor,5160,1521,4973,94,199,293,98,121,219,1185,220,2803
21/7/2021,Kedah,2664,744,2539,2,89,91,0,34,34,720,4,1227
21/7/2021,Kelantan,2737,541,2593,22,56,78,10,44,54,336,40,1182
21/7/2021,Melaka,1307,580,1173,3,58,61,15,51,66,558,23,535
21/7/2021,Negeri Sembilan,1749,1086,1658,3,149,152,12,100,112,948,7,530
21/7/2021,Pahang,2250,842,2182,10,72,82,17,68,85,447,56,740
21/7/2021,Perak,2728,399,2645,3,52,55,1,29,30,352,0,1568
21/7/2021,Perlis,487,87,471,11,1,12,1,1,2,23,24,203
21/7/2021,Pulau Pinang,1304,312,1244,0,35,35,0,25,25,282,0,764
21/7/2021,Sabah,3120,868,2954,17,67,84,4,30,34,458,68,1524
21/7/2021,Sarawak,3039,887,2833,78,185,263,69,221,290,357,310,2091
21/7/2021,Selangor,6452,3714,5997,85,469,554,31,354,385,3474,224,1743
21/7/2021,Terengganu,1481,565,1425,8,30,38,16,11,27,152,20,722
21/7/2021,W.P. Kuala Lumpur,3976,1715,3752,3,259,262,0,186,186,1840,63,1946
21/7/2021,W.P. Labuan,122,106,99,2,1,3,0,2,2,16,2,72
21/7/2021,W.P. Putrajaya,385,112,365,3,15,18,5,21,26,107,0,189
22/7/2021,Johor,5160,1521,4973,198,211,409,104,135,239,1248,286,2829
22/7/2021,Kedah,2664,744,2539,4,85,89,0,20,20,746,8,1360
22/7/2021,Kelantan,2737,541,2593,16,100,116,16,66,82,368,40,1242
22/7/2021,Melaka,1307,580,1173,16,41,57,5,67,72,536,33,558
22/7/2021,Negeri Sembilan,1749,1086,1658,0,156,156,3,135,138,923,5,473
22/7/2021,Pahang,2250,842,2182,7,62,69,22,56,78,448,42,760
22/7/2021,Perak,2728,468,2645,3,65,68,1,29,30,341,28,1603
22/7/2021,Perlis,487,87,471,6,8,14,7,3,10,24,18,225
22/7/2021,Pulau Pinang,1304,312,1244,0,30,30,0,30,30,281,0,782
22/7/2021,Sabah,3120,868,2954,29,60,89,12,37,49,478,88,1566
22/7/2021,Sarawak,4037,1279,3831,69,178,247,61,201,262,353,295,1836
22/7/2021,Selangor,6336,3794,5911,65,585,650,70,369,439,3483,202,2172
22/7/2021,Terengganu,1557,595,1501,10,30,40,13,13,26,168,17,747
22/7/2021,W.P. Kuala Lumpur,4555,1715,4335,2,234,236,1,162,163,1761,58,1341
22/7/2021,W.P. Labuan,145,106,122,1,2,3,0,1,1,15,0,73
22/7/2021,W.P. Putrajaya,385,112,359,7,26,33,6,20,26,113,20,187
23/7/2021,Johor,5160,1521,4973,157,169,326,105,151,256,1259,271,2774
23/7/2021,Kedah,2664,744,2539,8,66,74,0,43,43,745,11,1330
23/7/2021,Kelantan,2737,541,2593,12,54,66,21,74,95,350,31,1280
23/7/2021,Melaka,1307,580,1173,12,81,93,19,53,72,564,26,594
23/7/2021,Negeri Sembilan,1749,1086,1658,6,154,160,3,115,118,936,9,482
23/7/2021,Pahang,2250,842,2182,12,52,64,15,50,65,492,39,829
23/7/2021,Perak,2728,497,2645,5,67,72,1,31,32,368,29,1626
23/7/2021,Perlis,487,87,471,6,2,8,1,2,3,19,15,237
23/7/2021,Pulau Pinang,1304,312,1232,0,31,31,0,31,31,282,0,795
23/7/2021,Sabah,3120,909,2954,32,63,95,18,31,49,508,101,1592
23/7/2021,Sarawak,4037,1279,3831,102,396,498,74,263,337,364,291,1901
23/7/2021,Selangor,6336,3910,5899,95,638,733,67,481,548,3456,346,1754
23/7/2021,Terengganu,1557,595,1501,4,25,29,5,22,27,167,16,794
23/7/2021,W.P. Kuala Lumpur,4634,1748,4414,10,250,260,7,198,205,1750,61,1799
23/7/2021,W.P. Labuan,145,106,122,2,1,3,0,0,0,17,3,72
23/7/2021,W.P. Putrajaya,385,112,359,11,22,33,17,27,44,121,14,191
24/7/2021,Johor,5160,1562,4973,124,207,331,89,136,225,1322,244,2789
24/7/2021,Kedah,2664,744,2539,11,124,135,0,47,47,781,13,1300
24/7/2021,Kelantan,2737,541,2593,10,69,79,12,45,57,372,29,1271
24/7/2021,Melaka,1307,580,1173,1,4,5,0,0,0,567,27,578
24/7/2021,Negeri Sembilan,1749,1086,1658,3,151,154,0,128,128,936,8,445
24/7/2021,Pahang,2250,842,2182,17,76,93,20,52,72,505,36,739
24/7/2021,Perak,2728,497,2645,3,72,75,2,37,39,410,0,1544
24/7/2021,Perlis,487,87,471,6,7,13,9,1,10,26,15,216
24/7/2021,Pulau Pinang,1304,312,1232,0,42,42,0,28,28,289,0,781
24/7/2021,Sabah,3120,909,2954,5,71,76,10,34,44,482,72,1107
24/7/2021,Sarawak,4037,1279,3831,97,287,384,102,309,411,330,296,1859
24/7/2021,Selangor,6336,4015,5899,95,476,571,60,343,403,3668,334,1683
24/7/2021,Terengganu,1557,627,1501,7,32,39,8,19,27,181,16,793
24/7/2021,W.P. Kuala Lumpur,4634,1748,4414,3,227,230,3,198,201,1763,52,1715
24/7/2021,W.P. Labuan,122,106,99,0,13,13,1,0,1,28,2,72
24/7/2021,W.P. Putrajaya,385,112,359,8,39,47,7,37,44,123,15,176
25/7/2021,Johor,5160,1582,4973,129,165,294,116,143,259,1332,259,2806
25/7/2021,Kedah,2664,744,2539,12,108,120,0,52,52,813,21,1339
25/7/2021,Kelantan,2737,541,2593,8,83,91,10,41,51,410,27,1334
25/7/2021,Melaka,1307,580,1173,6,84,90,9,38,47,614,36,578
25/7/2021,Negeri Sembilan,1749,1086,1658,8,142,150,8,116,124,931,8,464
25/7/2021,Pahang,2250,842,2182,18,56,74,10,40,50,516,34,729
25/7/2021,Perak,2728,497,2645,1,70,71,1,32,33,404,40,1504
25/7/2021,Perlis,487,87,471,9,1,10,5,0,5,27,14,214
25/7/2021,Pulau Pinang,1304,312,1232,2,31,33,0,32,32,251,2,718
25/7/2021,Sabah,3120,917,2954,32,142,174,15,26,41,579,105,1368
25/7/2021,Sarawak,4037,1279,3831,80,352,432,74,193,267,368,265,1823
25/7/2021,Selangor,6336,4030,5899,77,492,569,51,338,389,3663,287,1697
25/7/2021,Terengganu,1557,627,1501,7,39,46,7,20,27,197,16,815
25/7/2021,W.P. Kuala Lumpur,4634,1748,4414,0,177,177,5,150,155,1756,58,1731
25/7/2021,W.P. Labuan,122,106,99,6,8,14,1,4,5,29,11,72
25/7/2021,W.P. Putrajaya,385,112,359,2,32,34,2,23,25,132,14,184
26/7/2021,Johor,5160,1582,4973,115,186,301,111,165,276,1348,259,2789
26/7/2021,Kedah,2664,744,2539,4,128,132,0,59,59,859,18,1293
26/7/2021,Kelantan,2737,559,2593,8,84,92,15,66,81,424,19,1422
26/7/2021,Melaka,1307,580,1173,1,1,2,0,0,0,615,37,628
26/7/2021,Negeri Sembilan,1749,1086,1658,10,132,142,0,124,124,897,18,443
26/7/2021,Pahang,2250,842,2182,9,42,51,10,48,58,548,43,731
26/7/2021,Perak,2728,497,2645,0,70,70,0,43,43,417,38,1527
26/7/2021,Perlis,487,87,471,9,4,13,2,3,5,29,15,254
26/7/2021,Pulau Pinang,1546,336,1467,2,46,48,0,25,25,306,2,709
26/7/2021,Sabah,3261,964,3095,43,104,147,17,41,58,596,132,1432
26/7/2021,Sarawak,4037,1279,3831,71,194,265,46,242,288,367,281,1868
26/7/2021,Selangor,6336,4092,5891,96,543,639,56,359,415,3742,244,1718
26/7/2021,Terengganu,1557,627,1501,9,30,39,5,26,31,198,20,930
26/7/2021,W.P. Kuala Lumpur,4780,1764,4560,10,207,217,0,240,240,1750,64,1747
26/7/2021,W.P. Labuan,122,106,99,0,3,3,0,5,5,29,7,69
26/7/2021,W.P. Putrajaya,385,112,359,6,19,25,9,29,38,122,11,188
27/7/2021,Johor,5160,1598,4973,161,220,381,98,193,291,1353,274,2902
27/7/2021,Kedah,2664,744,2539,8,138,146,0,77,77,859,13,1254
27/7/2021,Kelantan,2737,559,2593,16,78,94,19,80,99,416,16,1472
27/7/2021,Melaka,1307,580,1173,28,79,107,9,48,57,602,45,516
27/7/2021,Negeri Sembilan,1749,1086,1662,12,139,151,11,148,159,909,19,415
27/7/2021,Pahang,2250,842,2182,7,57,64,10,51,61,509,42,791
27/7/2021,Perak,2728,547,2628,2,62,64,4,42,46,453,0,1588
27/7/2021,Perlis,487,87,471,6,3,9,1,0,1,24,13,270
27/7/2021,Pulau Pinang,1546,336,1467,1,50,51,0,30,30,284,0,977
27/7/2021,Sabah,3261,964,3095,30,122,152,21,54,75,605,89,1532
27/7/2021,Sarawak,4037,1279,3831,92,190,282,81,373,454,376,278,1913
27/7/2021,Selangor,6336,4169,5935,57,684,741,54,437,491,3793,251,1570
27/7/2021,Terengganu,1557,653,1501,10,45,55,3,23,26,217,27,852
27/7/2021,W.P. Kuala Lumpur,4780,1850,4554,5,277,282,5,169,174,1825,67,1075
27/7/2021,W.P. Labuan,122,106,99,0,0,0,1,4,5,21,3,70
27/7/2021,W.P. Putrajaya,385,112,359,15,33,48,4,28,32,129,22,173
28/7/2021,Johor,5160,1600,4973,112,256,368,98,172,270,1407,263,2922
28/7/2021,Kedah,2664,974,2539,9,124,133,1,58,59,915,18,1328
28/7/2021,Kelantan,2737,559,2593,16,85,101,11,71,82,429,21,1459
28/7/2021,Melaka,1307,580,1173,1,1,2,0,0,0,603,46,530
28/7/2021,Negeri Sembilan,1749,1086,1660,9,143,152,14,124,138,911,13,272
28/7/2021,Pahang,2250,842,2182,20,66,86,9,71,80,505,52,731
28/7/2021,Perak,2728,581,2628,0,62,62,1,44,45,445,0,1625
28/7/2021,Perlis,487,87,471,7,3,10,1,5,6,26,13,264
28/7/2021,Pulau Pinang,1546,360,1465,2,45,47,0,24,24,321,2,992
28/7/2021,Sabah,3261,964,3095,35,145,180,29,52,81,630,85,1604
28/7/2021,Sarawak,4037,1279,3831,82,160,242,65,218,283,373,262,1933
28/7/2021,Selangor,6336,4271,5935,96,581,677,116,409,525,3703,244,1635
28/7/2021,Terengganu,1557,653,1501,14,48,62,5,22,27,240,34,864
28/7/2021,W.P. Kuala Lumpur,4780,1850,4554,12,180,192,1,193,194,1810,146,1323
28/7/2021,W.P. Labuan,122,106,99,0,0,0,0,1,1,21,3,74
28/7/2021,W.P. Putrajaya,385,112,359,10,21,31,3,29,32,121,29,178
29/7/2021,Johor,5160,1600,4973,165,241,406,129,169,298,1462,313,2777
29/7/2021,Kedah,2664,974,2539,3,133,136,0,50,50,931,9,1298
29/7/2021,Kelantan,2737,559,2593,21,75,96,19,64,83,438,23,1414
29/7/2021,Melaka,1307,580,1173,16,81,97,4,65,69,614,60,550
29/7/2021,Negeri Sembilan,1749,1086,1660,2,111,113,8,85,93,912,1,529
29/7/2021,Pahang,2250,842,2182,11,71,82,15,60,75,512,48,825
29/7/2021,Perak,2728,581,2628,2,50,52,0,49,49,432,0,1620
29/7/2021,Perlis,487,87,471,3,7,10,2,0,2,33,14,294
29/7/2021,Pulau Pinang,1546,360,1459,2,44,46,0,27,27,298,1,791
29/7/2021,Sabah,3261,964,3095,24,74,98,21,29,50,672,79,1598
29/7/2021,Sarawak,4037,1279,3831,68,232,300,59,228,287,379,245,1894
29/7/2021,Selangor,6336,4242,5935,81,523,604,63,516,579,3862,233,1553
29/7/2021,Terengganu,1557,663,1501,13,51,64,14,22,36,263,34,836
29/7/2021,W.P. Kuala Lumpur,4780,1932,4554,10,292,302,7,214,221,1864,68,1098
29/7/2021,W.P. Labuan,122,106,99,1,0,1,1,2,3,18,3,79
29/7/2021,W.P. Putrajaya,385,112,359,9,45,54,14,27,41,139,22,171
30/7/2021,Johor,5160,1600,4973,148,236,384,90,174,264,1501,318,2662
30/7/2021,Kedah,2664,974,2532,9,122,131,1,60,61,939,9,1238
30/7/2021,Kelantan,2737,559,2593,25,78,103,12,54,66,432,36,1151
30/7/2021,Melaka,1307,580,1171,17,61,78,10,42,52,633,47,505
30/7/2021,Negeri Sembilan,1749,1084,1660,6,138,144,0,108,108,952,11,482
30/7/2021,Pahang,2250,842,2161,18,64,82,14,67,81,502,51,759
30/7/2021,Perak,2728,581,2621,0,66,66,0,48,48,411,33,1581
30/7/2021,Perlis,487,87,471,2,5,7,1,1,2,34,7,304
30/7/2021,Pulau Pinang,1546,360,1459,3,52,55,0,29,29,332,3,759
30/7/2021,Sabah,3261,982,3073,39,93,132,14,41,55,730,103,1524
30/7/2021,Sarawak,4037,1279,3831,68,204,272,49,218,267,371,239,1882
30/7/2021,Selangor,6336,4494,5943,48,748,796,69,521,590,3862,243,1651
30/7/2021,Terengganu,1557,663,1501,16,40,56,13,34,47,263,39,721
30/7/2021,W.P. Kuala Lumpur,4780,1932,4550,14,262,276,6,217,223,1808,92,1294
30/7/2021,W.P. Labuan,122,106,99,0,0,0,1,2,3,13,2,93
30/7/2021,W.P. Putrajaya,385,112,359,7,29,36,5,32,37,136,27,176
31/7/2021,Johor,5160,1600,4973,132,222,354,97,180,277,1524,295,2723
31/7/2021,Kedah,2664,974,2532,24,145,169,0,44,44,1014,28,1216
31/7/2021,Kelantan,2704,580,2560,15,86,101,14,39,53,479,35,1271
31/7/2021,Melaka,1307,580,1171,10,82,92,12,48,60,658,61,510
31/7/2021,Negeri Sembilan,1749,1084,1660,0,156,156,1,94,95,987,10,472
31/7/2021,Pahang,2250,842,2161,17,49,66,13,48,61,763,56,759
31/7/2021,Perak,2797,650,2686,4,77,81,0,65,65,448,31,1533
31/7/2021,Perlis,487,87,471,4,4,8,0,1,1,37,13,301
31/7/2021,Pulau Pinang,1560,388,1473,2,47,49,0,42,42,358,2,743
31/7/2021,Sabah,3261,998,3073,31,112,143,28,44,72,759,99,1440
31/7/2021,Sarawak,4037,1279,3831,60,205,265,77,180,257,371,230,1806
31/7/2021,Selangor,6336,4432,5943,71,712,783,46,407,453,3833,165,1476
31/7/2021,Terengganu,1557,663,1501,9,42,51,14,21,35,277,36,711
31/7/2021,W.P. Kuala Lumpur,4780,1932,4550,8,213,221,9,195,204,1843,124,1304
31/7/2021,W.P. Labuan,122,106,99,0,1,1,0,1,1,11,2,61
31/7/2021,W.P. Putrajaya,385,112,359,11,36,47,10,34,44,138,31,175
1/8/2021,Johor,5160,1662,4973,106,253,359,84,190,274,1562,291,2652
1/8/2021,Kedah,2664,1044,2532,9,113,122,0,60,60,998,14,1233
1/8/2021,Kelantan,2704,580,2560,28,73,101,9,70,79,476,54,1316
1/8/2021,Melaka,1307,580,1171,2,51,53,26,52,78,657,37,460
1/8/2021,Negeri Sembilan,1749,1084,1660,1,114,115,10,115,125,951,5,469
1/8/2021,Pahang,2250,842,2161,14,81,95,19,49,68,517,49,758
1/8/2021,Perak,2797,650,2686,2,91,93,0,43,43,477,50,1471
1/8/2021,Perlis,487,87,471,7,5,12,1,7,8,37,13,313
1/8/2021,Pulau Pinang,1560,388,1473,2,50,52,0,34,34,376,2,942
1/8/2021,Sabah,3261,998,3073,31,71,102,24,66,90,762,109,1392
1/8/2021,Sarawak,4037,1279,3831,56,224,280,49,157,206,378,227,1792
1/8/2021,Selangor,6336,4388,5943,50,724,774,28,439,467,4025,217,1467
1/8/2021,Terengganu,1557,663,1501,4,42,46,7,36,43,280,33,775
1/8/2021,W.P. Kuala Lumpur,4780,1977,4550,2,183,185,0,144,144,1849,64,1276
1/8/2021,W.P. Labuan,122,106,99,0,1,1,0,0,0,11,2,59
1/8/2021,W.P. Putrajaya,385,112,359,8,37,45,7,21,28,154,30,181
2/8/2021,Johor,5160,1710,4973,136,195,331,100,180,280,1569,272,2645
2/8/2021,Kedah,2664,1044,2532,0,117,117,0,71,71,1004,6,1223
2/8/2021,Kelantan,2704,580,2560,20,96,116,26,89,115,475,48,1379
2/8/2021,Melaka,1307,580,1171,18,173,191,3,114,117,671,43,439
2/8/2021,Negeri Sembilan,1749,1084,1660,5,86,91,1,132,133,911,8,486
2/8/2021,Pahang,2250,842,2160,26,55,81,94,55,149,512,47,673
2/8/2021,Perak,2797,660,2686,2,85,87,0,54,54,525,27,1555
2/8/2021,Perlis,487,87,471,9,6,15,1,2,3,41,18,324
2/8/2021,Pulau Pinang,1560,426,1473,2,48,50,0,35,35,382,2,744
2/8/2021,Sabah,3261,1018,3073,44,144,188,21,58,79,781,140,1109
2/8/2021,Sarawak,4037,1279,3831,105,260,365,65,352,417,391,232,1814
2/8/2021,Selangor,6336,4426,5943,43,572,615,25,369,394,4079,163,1364
2/8/2021,Terengganu,1557,663,1501,14,41,55,8,42,50,275,39,11
2/8/2021,W.P. Kuala Lumpur,4780,1977,4550,3,229,232,3,158,161,1866,73,1289
2/8/2021,W.P. Labuan,122,106,99,0,3,3,0,1,1,11,2,1
2/8/2021,W.P. Putrajaya,385,112,359,6,30,36,7,41,48,143,29,177
3/8/2021,Johor,5160,1710,4973,131,258,389,89,188,277,1611,294,2654
3/8/2021,Kedah,2664,1044,2532,7,129,136,0,68,68,1029,8,1147
3/8/2021,Kelantan,2704,580,2560,19,79,98,29,73,102,482,38,1416
3/8/2021,Melaka,1307,605,1171,22,123,145,6,111,117,681,58,578
3/8/2021,Negeri Sembilan,1749,1084,1660,12,138,150,2,120,122,916,16,479
3/8/2021,Pahang,2250,842,2156,15,80,95,21,50,71,532,45,802
3/8/2021,Perak,2797,660,2684,4,111,115,5,62,67,523,27,1565
3/8/2021,Perlis,487,87,468,11,1,12,4,3,7,40,20,290
3/8/2021,Pulau Pinang,1560,426,1473,0,0,0,0,0,0,0,0,20
3/8/2021,Sabah,3338,1202,3150,39,163,202,39,59,98,832,137,1342
3/8/2021,Sarawak,4037,1279,3831,71,176,247,72,220,292,393,186,1909
3/8/2021,Selangor,6336,4426,5925,55,646,701,54,613,667,4131,176,1327
3/8/2021,Terengganu,1557,663,1501,7,41,48,14,31,45,277,36,840
3/8/2021,W.P. Kuala Lumpur,4780,2046,4550,5,231,236,0,199,199,1856,84,1076
3/8/2021,W.P. Labuan,122,106,99,1,0,1,0,0,0,8,3,50
3/8/2021,W.P. Putrajaya,385,112,359,5,31,36,2,24,26,150,30,180
4/8/2021,Johor,5160,1779,4973,163,279,442,128,236,364,1627,282,2626
4/8/2021,Kedah,2664,1044,2532,6,113,119,0,60,60,1070,10,1016
4/8/2021,Kelantan,2704,580,2560,26,99,125,15,60,75,518,48,1389
4/8/2021,Melaka,1307,605,1171,16,159,175,5,110,115,627,56,501
4/8/2021,Negeri Sembilan,1749,1084,1660,6,106,112,1,126,127,879,20,233
4/8/2021,Pahang,2250,842,2156,13,74,87,16,81,97,521,44,818
4/8/2021,Perak,2819,708,2706,0,100,100,1,54,55,574,0,1616
4/8/2021,Perlis,487,87,468,7,9,16,2,2,4,44,16,292
4/8/2021,Pulau Pinang,1560,426,1467,3,47,50,0,35,35,380,3,937
4/8/2021,Sabah,3338,1202,3150,34,175,209,26,64,90,877,124,1414
4/8/2021,Sarawak,4037,1279,3831,108,300,408,75,173,248,384,230,1891
4/8/2021,Selangor,6336,4426,5925,57,701,758,51,460,511,4178,174,1299
4/8/2021,Terengganu,1557,663,1501,9,47,56,8,39,47,283,32,804
4/8/2021,W.P. Kuala Lumpur,4780,2046,4550,7,181,188,3,203,206,1852,95,1076
4/8/2021,W.P. Labuan,122,106,99,0,1,1,1,0,1,9,1,59
4/8/2021,W.P. Putrajaya,385,112,359,7,29,36,13,30,43,149,23,166
5/8/2021,Johor,5160,1779,4973,177,238,415,112,208,320,1624,313,2564
5/8/2021,Kedah,2664,1044,2532,10,125,135,1,80,81,1067,14,1241
5/8/2021,Kelantan,2704,580,2560,31,109,140,21,86,107,535,57,1343
5/8/2021,Melaka,1307,605,1171,27,116,143,8,100,108,643,38,463
5/8/2021,Negeri Sembilan,1749,1084,1660,3,125,128,1,123,124,854,8,482
5/8/2021,Pahang,2250,842,2156,15,68,83,10,87,97,502,49,837
5/8/2021,Perak,2819,708,2706,3,98,101,0,73,73,588,0,1605
5/8/2021,Perlis,487,93,468,13,1,14,2,4,6,40,23,281
5/8/2021,Pulau Pinang,1560,426,1467,3,56,59,0,41,41,412,3,946
5/8/2021,Sabah,3338,1250,3149,36,141,177,36,72,108,888,124,1377
5/8/2021,Sarawak,4037,1279,3831,83,159,242,104,253,357,372,193,1974
5/8/2021,Selangor,6336,4627,5929,82,527,609,38,468,506,4095,241,1212
5/8/2021,Terengganu,1557,663,1501,20,47,67,15,38,53,288,24,743
5/8/2021,W.P. Kuala Lumpur,4780,2046,4550,10,307,317,7,212,219,1905,74,1105
5/8/2021,W.P. Labuan,122,106,99,0,0,0,0,0,0,7,1,68
5/8/2021,W.P. Putrajaya,385,112,359,5,27,32,4,34,38,142,14,183
6/8/2021,Johor,5160,1779,4973,171,289,460,139,216,355,1685,287,2439
6/8/2021,Kedah,2664,1044,2532,10,181,191,0,84,84,1084,16,1191
6/8/2021,Kelantan,2773,677,2629,17,114,131,30,129,159,518,45,1238
6/8/2021,Melaka,1307,605,1171,27,108,135,15,113,128,638,62,435
6/8/2021,Negeri Sembilan,1749,1084,1660,11,95,106,2,118,120,786,16,465
6/8/2021,Pahang,2250,842,2156,8,49,57,11,55,66,491,47,824
6/8/2021,Perak,2819,708,2706,3,119,122,0,69,69,614,0,1553
6/8/2021,Perlis,487,93,468,12,5,17,0,3,3,42,21,281
6/8/2021,Pulau Pinang,1560,426,1467,3,56,59,0,41,41,397,3,982
6/8/2021,Sabah,3475,1294,3286,58,181,239,33,58,91,919,162,1250
6/8/2021,Sarawak,4037,1279,3831,82,496,578,94,386,480,378,183,1968
6/8/2021,Selangor,6336,4627,5929,55,652,707,53,519,572,4128,204,1525
6/8/2021,Terengganu,1557,663,1501,18,50,68,8,20,28,321,46,770
6/8/2021,W.P. Kuala Lumpur,4780,2046,4550,10,248,258,5,236,241,1882,65,1099
6/8/2021,W.P. Labuan,122,106,99,1,2,3,0,0,0,6,2,77
6/8/2021,W.P. Putrajaya,385,140,359,6,50,56,12,32,44,160,17,179
7/8/2021,Johor,5160,1779,4973,118,204,322,110,165,275,1678,253,2474
7/8/2021,Kedah,2664,1044,2532,8,129,137,0,60,60,1111,22,1228
7/8/2021,Kelantan,2773,692,2625,12,139,151,22,72,94,574,35,1225
7/8/2021,Melaka,1307,605,1171,48,120,168,9,64,73,640,41,471
7/8/2021,Negeri Sembilan,1749,1084,1660,1,127,128,3,148,151,744,16,474
7/8/2021,Pahang,2250,842,2156,15,59,74,24,66,90,563,40,720
7/8/2021,Perak,2819,708,2707,6,106,112,5,81,86,570,31,1462
7/8/2021,Perlis,487,93,468,7,12,19,1,4,5,49,21,273
7/8/2021,Pulau Pinang,1560,426,1467,2,55,57,0,49,49,387,2,977
7/8/2021,Sabah,3475,1294,3286,25,110,135,27,76,103,953,142,1377
7/8/2021,Sarawak,4037,1279,3831,115,235,350,82,232,314,346,183,1923
7/8/2021,Selangor,6336,4631,5929,62,638,700,45,563,608,4106,158,1341
7/8/2021,Terengganu,1557,663,1501,20,43,63,20,30,50,328,47,783
7/8/2021,W.P. Kuala Lumpur,4780,2046,4548,4,259,263,6,223,229,1869,54,1025
7/8/2021,W.P. Labuan,122,106,99,0,3,3,1,0,1,7,1,72
7/8/2021,W.P. Putrajaya,385,140,359,7,10,17,4,24,28,146,20,167
8/8/2021,Johor,5160,1779,4973,142,233,375,89,184,273,1748,271,2494
8/8/2021,Kedah,2664,1044,2532,14,85,99,1,49,50,1131,17,1234
8/8/2021,Kelantan,2773,710,2625,15,133,148,12,77,89,626,37,1301
8/8/2021,Melaka,1307,605,1171,18,110,128,10,87,97,645,52,489
8/8/2021,Negeri Sembilan,1749,1084,1660,6,108,114,9,103,112,752,5,469
8/8/2021,Pahang,2250,842,2156,14,75,89,19,40,59,503,36,707
8/8/2021,Perak,2819,708,2707,3,102,105,2,57,59,619,0,1397
8/8/2021,Perlis,487,93,468,12,3,15,0,4,4,48,24,4
8/8/2021,Pulau Pinang,1560,460,1467,1,52,53,0,41,41,374,0,918
8/8/2021,Sabah,3475,1294,3286,25,72,97,30,53,83,940,138,1444
8/8/2021,Sarawak,4037,1279,3831,65,211,276,60,196,256,323,193,1967
8/8/2021,Selangor,6336,4626,5929,76,613,689,27,374,401,4218,237,1284
8/8/2021,Terengganu,1557,663,1501,14,49,63,15,54,69,317,44,769
8/8/2021,W.P. Kuala Lumpur,4780,2046,4531,6,233,239,1,180,181,1881,86,1274
8/8/2021,W.P. Labuan,122,106,99,0,0,0,0,0,0,5,0,75
8/8/2021,W.P. Putrajaya,385,140,359,4,25,29,2,20,22,151,22,161
9/8/2021,Johor,5160,1779,4973,167,284,451,91,222,313,1768,314,2471
9/8/2021,Kedah,2664,1044,2524,15,136,151,0,88,88,1135,17,691
9/8/2021,Kelantan,2773,710,2625,16,128,144,9,90,99,655,46,1282
9/8/2021,Melaka,1307,605,1171,8,80,88,7,64,71,595,31,489
9/8/2021,Negeri Sembilan,1749,1084,1660,3,87,90,6,120,126,667,6,487
9/8/2021,Pahang,2250,842,2156,15,64,79,7,61,68,497,45,832
9/8/2021,Perak,2819,764,2707,5,112,117,2,37,39,612,32,1488
9/8/2021,Perlis,487,101,468,20,9,29,0,3,3,54,33,236
9/8/2021,Pulau Pinang,1560,488,1467,0,68,68,0,44,44,420,0,903
9/8/2021,Sabah,3547,1342,3358,29,102,131,25,84,109,922,132,1441
9/8/2021,Sarawak,4037,1279,3831,77,223,300,67,212,279,368,168,1815
9/8/2021,Selangor,6336,4629,5929,73,518,591,51,420,471,4054,191,1455
9/8/2021,Terengganu,1557,663,1501,11,62,73,15,62,77,310,41,836
9/8/2021,W.P. Kuala Lumpur,4780,2058,4531,5,170,175,0,183,183,1854,102,1224
9/8/2021,W.P. Labuan,122,106,99,0,0,0,0,0,0,5,0,75
9/8/2021,W.P. Putrajaya,385,140,359,0,33,33,2,30,32,154,20,178
10/8/2021,Johor,5160,1818,4973,173,276,449,85,208,293,1787,311,2400
10/8/2021,Kedah,2664,1044,2524,2,123,125,0,92,92,1127,12,1214
10/8/2021,Kelantan,2773,812,2625,24,127,151,19,92,111,678,54,1285
10/8/2021,Melaka,1307,605,1171,15,75,90,8,78,86,582,38,507
10/8/2021,Negeri Sembilan,1749,1084,1660,5,98,103,4,67,71,683,7,471
10/8/2021,Pahang,2250,842,2156,14,71,85,15,88,103,478,53,777
10/8/2021,Perak,2819,764,2707,8,128,136,2,90,92,645,0,1485
10/8/2021,Perlis,487,101,468,9,14,23,1,5,6,60,31,255
10/8/2021,Pulau Pinang,1560,488,1467,2,106,108,0,34,34,478,2,855
10/8/2021,Sabah,3547,1339,3350,47,157,204,41,87,128,941,157,1340
10/8/2021,Sarawak,3997,1279,3791,88,403,491,50,280,330,381,186,1874
10/8/2021,Selangor,6336,4629,5929,77,720,797,51,410,461,3961,238,1142
10/8/2021,Terengganu,1557,663,1501,9,51,60,17,35,52,317,29,795
10/8/2021,W.P. Kuala Lumpur,4780,2066,4531,5,224,229,5,229,234,1897,110,1253
10/8/2021,W.P. Labuan,122,106,99,0,2,2,0,1,1,5,0,77
10/8/2021,W.P. Putrajaya,385,140,359,6,20,26,10,25,35,149,16,148
11/8/2021,Johor,5160,1818,4973,147,288,435,96,184,280,1867,266,2689
11/8/2021,Kedah,2664,1044,2524,10,137,147,0,69,69,1150,13,1242
11/8/2021,Kelantan,2824,812,2676,16,124,140,9,108,117,680,58,1308
11/8/2021,Melaka,1307,605,1171,25,84,109,9,67,76,641,76,458
11/8/2021,Negeri Sembilan,1749,1084,1660,4,86,90,1,96,97,625,10,489
11/8/2021,Pahang,2250,842,2156,18,87,105,12,57,69,503,49,804
11/8/2021,Perak,2819,764,2707,7,130,137,3,69,72,653,33,1498
11/8/2021,Perlis,487,101,468,9,5,14,2,3,5,62,38,249
11/8/2021,Pulau Pinang,1560,488,1467,0,70,70,0,44,44,441,12,894
11/8/2021,Sabah,3547,1342,3350,28,172,200,13,60,73,945,182,1279
11/8/2021,Sarawak,4037,1279,3831,99,291,390,51,255,306,391,170,2038
11/8/2021,Selangor,6302,4703,5895,60,673,733,32,534,566,4108,237,1417
11/8/2021,Terengganu,1557,663,1501,20,51,71,18,64,82,301,33,803
11/8/2021,W.P. Kuala Lumpur,4780,2066,4531,5,262,267,3,181,184,1859,117,1293
11/8/2021,W.P. Labuan,122,106,99,1,0,1,0,1,1,4,1,78
11/8/2021,W.P. Putrajaya,385,140,359,6,13,19,3,27,30,135,19,154
12/8/2021,Johor,5160,1852,4973,144,273,417,61,242,303,1860,326,2443
12/8/2021,Kedah,2664,1101,2524,9,176,185,0,117,117,1139,20,1220
12/8/2021,Kelantan,2824,812,2676,12,123,135,15,111,126,680,55,1324
12/8/2021,Melaka,1315,573,1179,16,68,84,9,22,31,577,63,522
12/8/2021,Negeri Sembilan,1749,1084,1660,3,96,99,6,83,89,631,8,510
12/8/2021,Pahang,2245,853,2151,15,56,71,15,60,75,491,49,841
12/8/2021,Perak,2819,790,2707,6,113,119,2,90,92,635,28,1510
12/8/2021,Perlis,487,129,468,14,15,29,0,2,2,67,41,276
12/8/2021,Pulau Pinang,1560,488,1467,9,86,95,0,45,45,450,10,955
12/8/2021,Sabah,3551,1346,3352,40,139,179,34,70,104,875,145,1223
12/8/2021,Sarawak,4037,1268,3831,71,310,381,69,283,352,389,142,2077
12/8/2021,Selangor,6302,4703,5895,112,614,726,52,313,365,4094,276,1388
12/8/2021,Terengganu,1557,663,1501,15,37,52,8,38,46,294,38,875
12/8/2021,W.P. Kuala Lumpur,4780,2066,4529,3,240,243,1,187,188,1831,106,1347
12/8/2021,W.P. Labuan,122,106,99,1,3,4,0,0,0,7,2,89
12/8/2021,W.P. Putrajaya,385,140,359,24,21,45,21,0,21,122,21,162
13/8/2021,Johor,5160,2038,4973,103,320,423,97,248,345,1925,241,2342
13/8/2021,Kedah,2664,1101,2524,12,159,171,7,131,138,1143,17,1197
13/8/2021,Kelantan,2824,812,2676,13,128,141,19,94,113,693,48,1433
13/8/2021,Melaka,1315,580,1179,19,89,108,6,69,75,692,81,489
13/8/2021,Negeri Sembilan,1749,1084,1652,22,90,112,3,94,97,682,45,745
13/8/2021,Pahang,2135,835,2043,14,61,75,3,39,42,428,42,824
13/8/2021,Perak,3277,985,3165,7,175,182,1,113,114,846,31,1514
13/8/2021,Perlis,487,129,468,16,16,32,0,4,4,80,36,265
13/8/2021,Pulau Pinang,1572,580,1471,2,88,90,0,46,46,494,11,902
13/8/2021,Sabah,3551,1346,3352,38,138,176,21,64,85,974,144,1330
13/8/2021,Sarawak,4055,1075,3849,109,224,333,59,306,365,387,145,2050
13/8/2021,Selangor,6302,4692,5895,82,587,669,68,541,609,3944,282,1435
13/8/2021,Terengganu,1557,663,1492,15,45,60,5,43,48,292,36,844
13/8/2021,W.P. Kuala Lumpur,4780,2066,4529,5,233,238,3,244,247,1744,111,1077
13/8/2021,W.P. Labuan,122,106,99,0,2,2,0,0,0,9,0,79
13/8/2021,W.P. Putrajaya,609,170,575,16,25,41,16,25,41,123,22,192
14/8/2021,Johor,5160,2038,4973,88,290,378,44,158,202,2062,244,1663
14/8/2021,Kedah,2664,1101,2524,8,123,131,1,48,49,1115,17,1199
14/8/2021,Kelantan,2824,812,2676,15,134,149,13,108,121,714,54,1157
14/8/2021,Melaka,1315,580,1179,22,74,96,11,71,82,673,104,537
14/8/2021,Negeri Sembilan,1749,1084,1652,13,92,105,8,116,124,606,32,724
14/8/2021,Pahang,2135,835,2043,14,42,56,2,38,40,485,39,910
14/8/2021,Perak,3277,1013,3165,8,147,155,8,98,106,800,30,1504
14/8/2021,Perlis,487,129,468,16,14,30,0,1,1,92,41,270
14/8/2021,Pulau Pinang,1985,644,1867,11,123,134,4,60,64,534,15,1157
14/8/2021,Sabah,3551,1347,3350,47,181,228,33,87,120,897,188,1357
14/8/2021,Sarawak,4055,1086,3849,57,77,134,48,283,331,295,129,2007
14/8/2021,Selangor,6302,4692,5895,83,614,697,60,424,484,4172,303,1319
14/8/2021,Terengganu,1557,663,1492,11,40,51,10,31,41,291,35,814
14/8/2021,W.P. Kuala Lumpur,4780,2066,4529,6,175,181,6,252,258,1611,77,1024
14/8/2021,W.P. Labuan,122,106,99,1,10,11,0,1,1,9,1,77
14/8/2021,W.P. Putrajaya,609,170,575,15,27,42,9,30,39,114,33,174
15/8/2021,Johor,5160,2189,5000,87,280,367,75,205,280,2066,234,2369
15/8/2021,Kedah,2664,1101,2524,14,127,141,2,98,100,1182,19,1190
15/8/2021,Kelantan,2824,812,2676,13,125,138,11,96,107,709,56,1356
15/8/2021,Melaka,1315,580,1179,31,96,127,21,62,83,641,66,539
15/8/2021,Negeri Sembilan,1749,1084,1652,15,75,90,8,28,36,586,31,724
15/8/2021,Pahang,2135,835,2043,14,66,80,6,42,48,485,31,924
15/8/2021,Perak,3277,1013,3165,7,159,166,9,63,72,838,35,1490
15/8/2021,Perlis,487,129,468,18,15,33,11,7,18,86,33,288
15/8/2021,Pulau Pinang,1985,644,1867,11,71,82,3,63,66,600,16,1084
15/8/2021,Sabah,3551,1347,3358,53,182,235,36,73,109,978,179,1311
15/8/2021,Sarawak,4055,1034,3849,73,327,400,74,245,319,315,117,2020
15/8/2021,Selangor,6302,4713,5895,61,514,575,43,349,392,3979,260,1346
15/8/2021,Terengganu,1557,663,1492,10,40,50,13,34,47,293,35,914
15/8/2021,W.P. Kuala Lumpur,4780,2066,4529,12,154,166,2,105,107,1597,82,1266
15/8/2021,W.P. Labuan,122,106,99,0,0,0,1,1,2,8,0,67
15/8/2021,W.P. Putrajaya,609,170,575,15,12,27,10,15,25,109,24,159
16/8/2021,Johor,5160,2189,5000,138,253,391,47,229,276,2075,266,2439
16/8/2021,Kedah,2664,1101,2524,10,147,157,3,94,97,1177,20,1208
16/8/2021,Kelantan,2824,812,2676,10,127,137,16,113,129,736,52,1262
16/8/2021,Melaka,1315,580,1179,16,74,90,8,62,70,623,81,528
16/8/2021,Negeri Sembilan,1749,1084,1652,23,76,99,13,34,47,528,42,665
16/8/2021,Pahang,2135,835,2043,14,91,105,12,52,64,533,40,890
16/8/2021,Perak,3277,1059,3165,9,130,139,2,78,80,849,33,1557
16/8/2021,Perlis,487,129,468,16,8,24,1,1,2,83,40,273
16/8/2021,Pulau Pinang,1985,644,1867,20,115,135,3,116,119,836,22,860
16/8/2021,Sabah,3551,1415,3358,55,99,154,34,59,93,1021,191,1403
16/8/2021,Sarawak,4055,1034,3849,47,193,240,35,177,212,326,116,2029
16/8/2021,Selangor,6302,4713,5895,77,449,526,171,304,475,3924,249,1377
16/8/2021,Terengganu,1557,663,1492,12,38,50,15,43,58,269,28,950
16/8/2021,W.P. Kuala Lumpur,4780,2066,4529,5,182,187,2,123,125,1656,117,1093
16/8/2021,W.P. Labuan,122,106,99,0,0,0,0,0,0,8,0,67
16/8/2021,W.P. Putrajaya,609,168,575,15,14,29,11,19,30,109,31,186
17/8/2021,Johor,5160,2189,5000,127,320,447,91,238,329,2081,287,2315
17/8/2021,Kedah,2664,1101,2524,6,167,173,2,92,94,1183,22,650
17/8/2021,Kelantan,2824,812,2676,14,136,150,14,127,141,742,49,1254
17/8/2021,Melaka,1315,688,1179,19,70,89,15,54,69,625,45,687
17/8/2021,Negeri Sembilan,1749,1084,1652,14,73,87,12,116,128,411,34,251
17/8/2021,Pahang,2135,835,2043,15,61,76,11,43,54,550,49,886
17/8/2021,Perak,3277,1079,3165,7,146,153,6,101,107,809,21,1565
17/8/2021,Perlis,487,129,468,11,7,18,0,10,10,80,46,271
17/8/2021,Pulau Pinang,1985,644,1867,14,125,139,3,101,104,840,23,901
17/8/2021,Sabah,3551,1415,3358,45,194,239,46,86,132,1060,186,1456
17/8/2021,Sarawak,4055,1034,3849,80,285,365,55,281,336,323,116,1981
17/8/2021,Selangor,6302,4713,5894,74,517,591,44,428,472,3648,280,1454
17/8/2021,Terengganu,1557,477,1492,8,46,54,11,40,51,275,26,974
17/8/2021,W.P. Kuala Lumpur,4780,2066,4529,1,170,171,2,128,130,1604,104,1335
17/8/2021,W.P. Labuan,122,106,99,0,0,0,0,1,1,7,0,75
17/8/2021,W.P. Putrajaya,609,168,575,14,12,26,13,22,35,100,36,183
18/8/2021,Johor,5160,2189,5000,113,381,494,93,244,337,2076,258,2349
18/8/2021,Kedah,2664,1101,2524,12,183,195,2,102,104,1186,16,1119
18/8/2021,Kelantan,2824,812,2676,19,159,178,13,121,134,787,56,1316
18/8/2021,Melaka,1315,688,1179,10,62,72,11,62,73,623,36,576
18/8/2021,Negeri Sembilan,1749,1084,1649,29,73,102,13,96,109,472,23,664
18/8/2021,Pahang,2135,835,2043,13,56,69,19,68,87,509,33,874
18/8/2021,Perak,3277,1079,3165,10,125,135,2,98,100,811,25,1590
18/8/2021,Perlis,487,129,468,19,11,30,0,4,4,84,59,267
18/8/2021,Pulau Pinang,1985,644,1867,1,121,122,0,95,95,848,18,959
18/8/2021,Sabah,3662,1455,3509,56,153,209,42,31,73,1042,191,1523
18/8/2021,Sarawak,4055,1034,3849,74,406,480,72,422,494,306,124,2069
18/8/2021,Selangor,6302,4713,5894,65,516,581,68,389,457,3633,283,1539
18/8/2021,Terengganu,1557,477,1492,9,39,48,7,45,52,269,26,989
18/8/2021,W.P. Kuala Lumpur,4780,2066,4529,7,163,170,3,202,205,1557,105,1238
18/8/2021,W.P. Labuan,122,106,99,2,0,2,0,0,0,7,2,75
18/8/2021,W.P. Putrajaya,609,168,575,16,10,26,10,22,32,98,37,177
19/8/2021,Johor,5160,2189,5000,121,286,407,91,268,359,2073,220,2288
19/8/2021,Kedah,2664,1101,2524,17,131,148,4,114,118,1142,40,1187
19/8/2021,Kelantan,2824,812,2676,15,143,158,19,135,154,733,49,1293
19/8/2021,Melaka,1315,688,1175,11,65,76,6,67,73,589,28,474
19/8/2021,Negeri Sembilan,1749,1084,1639,25,65,90,19,94,113,424,13,748
19/8/2021,Pahang,2135,835,2043,22,35,57,8,45,53,491,52,833
19/8/2021,Perak,3277,1090,3159,10,148,158,5,109,114,825,29,1681
19/8/2021,Perlis,487,157,468,20,25,45,0,1,1,103,53,290
19/8/2021,Pulau Pinang,1985,644,1867,13,117,130,3,95,98,878,23,906
19/8/2021,Sabah,3662,1564,3509,52,187,239,41,83,124,1154,172,1555
19/8/2021,Sarawak,4055,1034,3849,92,274,366,51,199,250,333,118,2151
19/8/2021,Selangor,6302,4713,5894,88,473,561,50,331,381,3601,316,1447
19/8/2021,Terengganu,1557,477,1492,17,40,57,6,18,24,266,35,944
19/8/2021,W.P. Kuala Lumpur,4753,1988,4502,0,144,144,2,168,170,1462,113,1338
19/8/2021,W.P. Labuan,122,106,99,0,0,0,2,1,3,6,0,77
19/8/2021,W.P. Putrajaya,609,168,575,21,20,41,19,21,40,101,42,183
20/8/2021,Johor,5160,2312,5000,118,253,371,68,255,323,2011,201,2256
20/8/2021,Kedah,2664,1101,2524,18,142,160,9,106,115,1103,27,1150
20/8/2021,Kelantan,2824,852,2676,16,120,136,21,97,118,793,41,1245
20/8/2021,Melaka,1315,688,1175,13,76,89,9,58,67,643,15,566
20/8/2021,Negeri Sembilan,1749,1084,1639,16,60,76,8,68,76,421,28,775
20/8/2021,Pahang,2135,835,2043,10,60,70,15,51,66,471,39,743
20/8/2021,Perak,3277,1050,3159,12,161,173,5,86,91,842,31,1660
20/8/2021,Perlis,487,157,468,30,15,45,1,2,3,107,63,294
20/8/2021,Pulau Pinang,1985,644,1867,3,129,132,3,109,112,880,10,888
20/8/2021,Sabah,3662,1564,3509,48,203,251,45,42,87,1210,165,1470
20/8/2021,Sarawak,4055,1034,3849,90,361,451,64,222,286,348,125,2015
20/8/2021,Selangor,6302,4625,5894,87,495,582,67,166,233,3446,300,1440
20/8/2021,Terengganu,1557,477,1492,9,32,41,14,35,49,262,28,929
20/8/2021,W.P. Kuala Lumpur,4753,1917,4502,2,145,147,3,171,174,1404,111,1363
20/8/2021,W.P. Labuan,122,106,99,0,1,1,0,0,0,6,0,75
20/8/2021,W.P. Putrajaya,609,168,575,9,10,19,9,14,23,98,40,198
21/8/2021,Johor,5160,2312,5000,123,266,389,75,222,297,2042,214,2214
21/8/2021,Kedah,2664,1101,2524,21,124,145,13,68,81,1149,12,1185
21/8/2021,Kelantan,2824,852,2676,11,117,128,5,76,81,760,12,1188
21/8/2021,Melaka,1315,688,1175,6,65,71,9,77,86,641,42,559
21/8/2021,Negeri Sembilan,1749,1084,1639,14,87,101,24,83,107,429,32,724
21/8/2021,Pahang,2135,835,2043,14,52,66,9,67,76,496,46,794
21/8/2021,Perak,3277,1050,3159,7,130,137,1,99,100,786,21,1563
21/8/2021,Perlis,487,157,468,37,15,52,0,6,6,99,91,249
21/8/2021,Pulau Pinang,1985,644,1867,4,129,133,0,122,122,854,12,850
21/8/2021,Sabah,3714,1593,3561,42,215,257,44,88,132,1181,167,1416
21/8/2021,Sarawak,4055,1034,3849,86,285,371,56,261,317,339,148,2005
21/8/2021,Selangor,6302,4625,5894,93,429,522,54,475,529,3457,273,1513
21/8/2021,Terengganu,1557,477,1492,9,45,54,14,54,68,255,22,952
21/8/2021,W.P. Kuala Lumpur,4753,1890,4502,3,141,144,4,163,167,1340,102,1241
21/8/2021,W.P. Labuan,122,106,99,0,0,0,0,1,1,3,1,71
21/8/2021,W.P. Putrajaya,609,168,575,13,12,25,12,13,25,96,39,180
22/8/2021,Johor,5160,2312,5000,91,274,365,58,198,256,2125,187,2311
22/8/2021,Kedah,2664,1101,2524,8,119,127,6,73,79,1129,10,769
22/8/2021,Kelantan,2824,852,2676,16,114,130,17,102,119,767,45,1332
22/8/2021,Melaka,1315,688,1175,14,58,72,3,53,56,587,46,564
22/8/2021,Negeri Sembilan,1749,1084,1639,10,54,64,6,56,62,448,23,558
22/8/2021,Pahang,2135,835,2043,8,46,54,11,41,52,493,40,839
22/8/2021,Perak,3277,1050,3159,8,124,132,2,105,107,846,23,1586
22/8/2021,Perlis,487,185,468,27,18,45,0,4,4,116,62,282
22/8/2021,Pulau Pinang,1985,644,1867,6,109,115,3,115,118,801,9,828
22/8/2021,Sabah,3714,1593,3561,35,170,205,28,80,108,1240,164,1402
22/8/2021,Sarawak,4055,1034,3849,129,273,402,56,214,270,340,146,1883
22/8/2021,Selangor,6302,4625,5894,79,406,485,35,251,286,3349,302,1478
22/8/2021,Terengganu,1557,477,1492,6,38,44,6,28,34,266,20,978
22/8/2021,W.P. Kuala Lumpur,4753,1890,4502,2,191,193,4,152,156,1254,98,1279
22/8/2021,W.P. Labuan,122,106,99,0,1,1,0,1,1,4,0,67
22/8/2021,W.P. Putrajaya,609,168,575,12,9,21,7,18,25,87,41,185
23/8/2021,Johor,5160,2312,5000,113,304,417,71,257,328,2139,203,2276
23/8/2021,Kedah,2664,1101,2524,55,178,233,31,96,127,1122,17,849
23/8/2021,Kelantan,2824,866,2676,33,124,157,9,113,122,734,31,930
23/8/2021,Melaka,1315,688,1175,13,52,65,10,7,17,621,65,580
23/8/2021,Negeri Sembilan,1749,1084,1639,10,39,49,18,79,97,370,19,711
23/8/2021,Pahang,2135,835,2043,12,50,62,8,25,33,512,46,844
23/8/2021,Perak,3277,1050,3159,12,115,127,3,90,93,813,30,1685
23/8/2021,Perlis,487,185,468,15,15,30,0,1,1,121,62,275
23/8/2021,Pulau Pinang,1985,644,1867,4,133,137,1,86,87,834,9,869
23/8/2021,Sabah,3637,1573,3479,34,99,133,40,47,87,1159,159,1339
23/8/2021,Sarawak,4055,1034,3849,78,268,346,54,290,344,367,137,2001
23/8/2021,Selangor,6302,4600,5894,77,393,470,45,303,348,3317,271,1427
23/8/2021,Terengganu,1557,477,1492,21,30,51,4,55,59,257,36,1111
23/8/2021,W.P. Kuala Lumpur,4753,1890,4502,0,110,110,2,112,114,1239,126,1343
23/8/2021,W.P. Labuan,122,106,99,0,0,0,0,0,0,6,0,66
23/8/2021,W.P. Putrajaya,609,168,575,9,13,22,15,14,29,85,35,170
24/8/2021,Johor,5160,2403,5000,138,345,483,74,278,352,2177,223,2270
24/8/2021,Kedah,2664,1101,2524,9,165,174,7,127,134,1086,17,798
24/8/2021,Kelantan,2824,866,2676,23,140,163,18,112,130,752,45,1341
24/8/2021,Melaka,1315,688,1175,11,40,51,14,49,63,572,64,509
24/8/2021,Negeri Sembilan,1749,1084,1639,19,67,86,5,44,49,384,26,736
24/8/2021,Pahang,2135,835,2043,13,50,63,7,61,68,497,52,855
24/8/2021,Perak,3277,1050,3159,17,161,178,4,119,123,818,29,1661
24/8/2021,Perlis,487,185,468,16,15,31,0,3,3,127,49,319
24/8/2021,Pulau Pinang,1985,784,1867,7,123,130,0,105,105,810,2,918
24/8/2021,Sabah,3709,1593,3551,46,211,257,53,33,86,1267,154,1306
24/8/2021,Sarawak,4055,949,3849,108,355,463,73,318,391,380,158,2072
24/8/2021,Selangor,6302,4560,5894,102,426,528,83,431,514,3159,289,1477
24/8/2021,Terengganu,1557,477,1492,13,41,54,4,26,30,262,41,1022
24/8/2021,W.P. Kuala Lumpur,4753,1890,4502,1,117,118,3,126,129,1162,108,1294
24/8/2021,W.P. Labuan,122,106,99,0,0,0,0,0,0,5,1,73
24/8/2021,W.P. Putrajaya,609,168,575,15,16,31,13,20,33,80,35,181
25/8/2021,Johor,5160,2403,5000,147,334,481,78,276,354,2196,223,2263
25/8/2021,Kedah,2664,1165,2517,24,147,171,2,94,96,1085,34,1198
25/8/2021,Kelantan,2824,899,2676,17,138,155,27,125,152,744,37,1326
25/8/2021,Melaka,1315,688,1175,12,43,55,13,64,77,514,63,635
25/8/2021,Negeri Sembilan,1749,1084,1639,25,65,90,19,48,67,398,35,734
25/8/2021,Pahang,2135,835,2043,39,69,108,18,70,88,463,68,850
25/8/2021,Perak,3277,1050,3159,11,170,181,5,107,112,842,27,1774
25/8/2021,Perlis,487,185,468,17,14,31,0,14,14,120,51,297
25/8/2021,Pulau Pinang,1985,784,1867,8,138,146,2,126,128,900,14,867
25/8/2021,Sabah,3709,1593,3551,46,204,250,27,66,93,1219,176,1410
25/8/2021,Sarawak,4055,999,3849,103,442,545,87,243,330,419,185,2086
25/8/2021,Selangor,6302,4560,5866,122,388,510,70,421,491,3118,309,1465
25/8/2021,Terengganu,1557,477,1492,9,75,84,20,28,48,302,27,909
25/8/2021,W.P. Kuala Lumpur,4753,1890,4502,3,90,93,2,57,59,1089,115,1294
25/8/2021,W.P. Labuan,122,106,99,0,0,0,0,1,1,5,1,74
25/8/2021,W.P. Putrajaya,609,168,575,28,15,43,20,23,43,74,43,195
26/8/2021,Johor,5160,2403,5000,149,361,510,68,298,366,2207,220,2373
26/8/2021,Kedah,2664,1165,2517,14,130,144,14,106,120,1071,17,798
26/8/2021,Kelantan,2824,899,2676,22,146,168,10,117,127,762,48,1255
26/8/2021,Melaka,1315,688,1175,20,44,64,14,68,82,23,57,584
26/8/2021,Negeri Sembilan,1749,1084,1639,27,65,92,15,72,87,374,31,750
26/8/2021,Pahang,2145,734,2053,21,41,62,10,42,52,424,72,866
26/8/2021,Perak,3277,1050,3159,8,151,159,7,98,105,842,26,1811
26/8/2021,Perlis,487,185,468,29,35,64,3,18,21,129,61,292
26/8/2021,Pulau Pinang,1985,784,1867,4,139,143,4,110,114,907,14,902
26/8/2021,Sabah,3709,1593,3551,82,196,278,37,91,128,1269,203,1424
26/8/2021,Sarawak,4055,1019,3849,123,424,547,76,327,403,445,192,2148
26/8/2021,Selangor,6302,4560,5866,133,416,549,114,333,447,2936,316,1450
26/8/2021,Terengganu,1557,477,1492,15,40,55,8,40,48,297,35,871
26/8/2021,W.P. Kuala Lumpur,4753,1890,4499,9,101,110,4,105,109,1118,97,1357
26/8/2021,W.P. Labuan,122,106,99,3,0,3,0,0,0,4,4,77
26/8/2021,W.P. Putrajaya,609,168,575,29,12,41,13,12,25,76,54,204
27/8/2021,Johor,5160,2423,5000,137,303,440,65,278,343,2230,240,2264
27/8/2021,Kedah,2664,1165,2517,13,136,149,5,97,102,1079,23,1183
27/8/2021,Kelantan,2852,899,2704,12,167,179,16,134,150,771,44,1198
27/8/2021,Melaka,1315,688,1175,19,48,67,17,3,20,475,8,650
27/8/2021,Negeri Sembilan,1749,1084,1639,26,58,84,20,62,82,365,27,777
27/8/2021,Pahang,2145,734,2053,16,59,75,17,61,78,428,64,853
27/8/2021,Perak,3277,1050,3159,15,144,159,3,120,123,819,33,1770
27/8/2021,Perlis,487,185,468,24,25,49,3,11,14,131,45,317
27/8/2021,Pulau Pinang,1985,784,1867,13,100,113,0,87,87,874,4,895
27/8/2021,Sabah,3729,1641,3566,57,139,196,42,82,124,1154,160,1364
27/8/2021,Sarawak,4055,1019,3849,97,409,506,88,271,359,459,188,2081
27/8/2021,Selangor,6302,4560,5866,122,329,451,97,289,386,2864,328,1502
27/8/2021,Terengganu,1557,477,1492,14,43,57,8,40,48,300,40,861
27/8/2021,W.P. Kuala Lumpur,4753,1890,4487,2,101,103,8,107,115,954,92,1335
27/8/2021,W.P. Labuan,122,106,99,3,0,3,2,1,3,4,5,88
27/8/2021,W.P. Putrajaya,609,168,575,22,10,32,17,9,26,75,63,218
28/8/2021,Johor,5160,2423,5000,105,377,482,108,263,371,2275,194,2293
28/8/2021,Kedah,2664,1165,2517,9,113,122,2,75,77,1070,14,1112
28/8/2021,Kelantan,2852,899,2704,21,167,188,17,91,108,798,66,1229
28/8/2021,Melaka,1315,688,1175,12,51,63,17,45,62,476,62,624
28/8/2021,Negeri Sembilan,1749,1084,1639,14,49,63,20,69,89,338,23,744
28/8/2021,Pahang,2145,734,2053,10,59,69,16,39,55,440,57,838
28/8/2021,Perak,3277,1050,3159,9,161,170,2,104,106,853,33,1633
28/8/2021,Perlis,487,185,468,18,25,43,0,8,8,135,43,301
28/8/2021,Pulau Pinang,1985,784,1867,6,112,118,3,96,99,848,15,832
28/8/2021,Sabah,3729,1555,3566,51,165,216,39,87,126,1291,174,1357
28/8/2021,Sarawak,4055,1019,3849,132,436,568,95,293,388,479,190,2051
28/8/2021,Selangor,6302,4560,5866,115,359,474,65,396,461,2631,369,1484
28/8/2021,Terengganu,1557,477,1492,18,48,66,12,43,55,307,45,807
28/8/2021,W.P. Kuala Lumpur,4753,1750,4487,1,93,94,3,90,93,901,69,1255
28/8/2021,W.P. Labuan,122,106,99,0,3,3,0,0,0,7,2,94
28/8/2021,W.P. Putrajaya,609,168,575,26,11,37,30,9,39,75,54,213
29/8/2021,Johor,5160,2423,5000,153,305,458,64,213,277,2320,251,2335
29/8/2021,Kedah,2664,1165,2517,14,127,141,12,45,57,1092,14,764
29/8/2021,Kelantan,2863,899,2715,25,157,182,12,86,98,826,60,1296
29/8/2021,Melaka,1315,688,1175,20,44,64,13,52,65,508,59,651
29/8/2021,Negeri Sembilan,1749,1084,1639,26,66,92,14,46,60,356,34,1022
29/8/2021,Pahang,2145,734,2053,16,51,67,10,28,38,462,65,834
29/8/2021,Perak,3277,1050,3159,11,138,149,2,71,73,859,38,1658
29/8/2021,Perlis,487,185,468,10,15,25,0,8,8,132,35,318
29/8/2021,Pulau Pinang,1985,784,1867,6,143,149,1,90,91,900,17,789
29/8/2021,Sabah,3999,1571,3836,39,172,211,34,78,112,1368,218,1407
29/8/2021,Sarawak,4055,1019,3849,102,341,443,49,226,275,477,211,2053
29/8/2021,Selangor,6302,4543,5866,85,362,447,47,275,322,2652,332,1531
29/8/2021,Terengganu,1557,477,1492,14,46,60,6,37,43,311,52,805
29/8/2021,W.P. Kuala Lumpur,4753,1750,4487,8,83,91,1,55,56,865,83,1303
29/8/2021,W.P. Labuan,122,106,99,0,0,0,0,0,0,6,1,90
29/8/2021,W.P. Putrajaya,609,168,575,15,6,21,12,13,25,67,54,214
30/8/2021,Johor,5160,2453,5000,130,349,479,95,305,400,2295,249,2302
30/8/2021,Kedah,2664,1165,2517,13,137,150,4,105,109,1093,25,838
30/8/2021,Kelantan,2863,899,2684,18,151,169,14,114,128,760,48,1358
30/8/2021,Melaka,1315,681,1169,13,49,62,16,46,62,495,43,632
30/8/2021,Negeri Sembilan,1749,1084,1639,14,46,60,18,67,85,334,21,759
30/8/2021,Pahang,2145,734,2053,5,47,52,13,56,69,463,59,823
30/8/2021,Perak,3277,1050,3159,15,149,164,3,87,90,896,36,1712
30/8/2021,Perlis,487,185,468,9,19,28,1,7,8,137,35,311
30/8/2021,Pulau Pinang,1985,765,1867,1,136,137,1,106,107,926,14,834
30/8/2021,Sabah,3999,1696,3836,57,135,192,42,86,128,1358,223,1386
30/8/2021,Sarawak,4055,1072,3849,105,372,477,182,138,320,497,213,2030
30/8/2021,Selangor,6302,4543,5866,85,293,378,55,251,306,2631,335,1569
30/8/2021,Terengganu,1557,477,1492,22,51,73,17,46,63,311,54,749
30/8/2021,W.P. Kuala Lumpur,4753,1750,4487,1,104,105,3,75,78,894,93,1347
30/8/2021,W.P. Labuan,122,106,99,0,0,0,0,0,0,5,1,85
30/8/2021,W.P. Putrajaya,609,168,575,20,11,31,15,11,26,67,60,227
31/8/2021,Johor,5160,2453,5000,156,358,514,79,300,379,2271,278,2295
31/8/2021,Kedah,2664,1165,2517,10,158,168,3,95,98,1065,28,773
31/8/2021,Kelantan,2863,899,2684,30,152,182,8,101,109,756,77,1350
31/8/2021,Melaka,1315,681,1169,17,46,63,14,59,73,408,36,656
31/8/2021,Negeri Sembilan,1749,1084,1639,23,47,70,10,74,84,298,34,815
31/8/2021,Pahang,2145,734,2053,8,63,71,11,62,73,434,55,917
31/8/2021,Perak,3277,1050,3159,12,157,169,5,118,123,893,31,1643
31/8/2021,Perlis,487,185,468,25,25,50,0,6,6,150,53,286
31/8/2021,Pulau Pinang,1985,829,1867,5,110,115,2,80,82,921,8,804
31/8/2021,Sabah,3999,1716,3836,53,172,225,31,59,90,1401,285,1369
31/8/2021,Sarawak,4055,1072,3849,140,276,416,79,185,264,516,208,2044
31/8/2021,Selangor,6302,4247,5866,105,285,390,61,242,303,2424,353,1493
31/8/2021,Terengganu,1557,477,1492,18,70,88,16,64,80,331,56,879
31/8/2021,W.P. Kuala Lumpur,4753,1626,4487,4,83,87,5,81,86,865,106,1306
31/8/2021,W.P. Labuan,122,106,99,0,0,0,1,0,1,5,0,87
31/8/2021,W.P. Putrajaya,609,168,575,8,10,18,19,7,26,69,46,226
1/9/2021,Johor,5160,2461,5000,113,237,350,76,279,355,2223,254,2348
1/9/2021,Kedah,2664,1165,2517,12,133,145,4,89,93,1077,20,1245
1/9/2021,Kelantan,2863,899,2684,16,158,174,11,103,114,808,48,1317
1/9/2021,Melaka,1212,622,1078,15,39,54,15,38,53,397,46,555
1/9/2021,Negeri Sembilan,1749,1084,1639,21,36,57,22,35,57,284,32,817
1/9/2021,Pahang,2145,734,2053,12,45,57,19,22,41,454,43,847
1/9/2021,Perak,3277,1054,3159,13,143,156,1,77,78,887,30,1697
1/9/2021,Perlis,487,185,468,9,22,31,0,24,24,145,44,275
1/9/2021,Pulau Pinang,1985,829,1867,16,139,155,0,64,64,947,21,889
1/9/2021,Sabah,4109,1884,3946,46,168,214,33,85,118,1432,294,1418
1/9/2021,Sarawak,4055,1072,3849,120,305,425,102,201,303,551,216,2091
1/9/2021,Selangor,6302,4247,5866,104,250,354,45,209,254,2418,366,1538
1/9/2021,Terengganu,1557,477,1492,11,42,53,22,47,69,325,41,881
1/9/2021,W.P. Kuala Lumpur,4753,1626,4493,5,87,92,5,61,66,842,95,1395
1/9/2021,W.P. Labuan,122,106,99,0,0,0,0,0,0,5,0,89
1/9/2021,W.P. Putrajaya,609,168,575,20,5,25,8,5,13,68,60,241
2/9/2021,Johor,5160,2461,5000,131,407,538,75,366,441,2194,303,2267
2/9/2021,Kedah,2664,1165,2517,10,102,112,6,90,96,1055,16,1246
2/9/2021,Kelantan,2863,931,2684,17,148,165,21,112,133,799,70,1292
2/9/2021,Melaka,1315,651,1175,19,30,49,17,54,71,365,45,662
2/9/2021,Negeri Sembilan,1749,1084,1639,25,48,73,14,42,56,286,35,828
2/9/2021,Pahang,2145,734,2053,15,52,67,7,25,32,449,42,859
2/9/2021,Perak,3277,1054,3159,19,187,206,11,123,134,884,39,1797
2/9/2021,Perlis,487,185,468,25,28,53,0,9,9,156,39,269
2/9/2021,Pulau Pinang,1985,829,1866,11,87,98,1,79,80,911,3,828
2/9/2021,Sabah,4109,1884,3946,40,188,228,46,122,168,1427,251,1518
2/9/2021,Sarawak,4055,1072,3849,161,346,507,83,194,277,580,229,2106
2/9/2021,Selangor,6302,4247,5879,101,291,392,88,376,464,2232,339,1594
2/9/2021,Terengganu,1557,491,1497,11,50,61,17,51,68,325,41,879
2/9/2021,W.P. Kuala Lumpur,4753,1626,4493,3,78,81,3,89,92,798,130,1371
2/9/2021,W.P. Labuan,122,106,99,3,0,3,0,0,0,5,3,91
2/9/2021,W.P. Putrajaya,609,168,575,9,6,15,11,11,22,63,54,221
3/9/2021,Johor,5160,2461,5000,154,308,462,121,261,382,2175,291,2178
3/9/2021,Kedah,2664,1165,2517,11,115,126,4,103,107,992,18,1256
3/9/2021,Kelantan,2863,931,2684,23,125,148,21,118,139,740,80,1237
3/9/2021,Melaka,1315,651,1175,17,42,59,20,35,55,390,15,665
3/9/2021,Negeri Sembilan,1749,1084,1639,17,48,65,19,43,62,290,29,868
3/9/2021,Pahang,2145,734,2060,15,61,76,12,38,50,452,44,849
3/9/2021,Perak,3277,1064,3159,16,162,178,6,117,123,877,40,1799
3/9/2021,Perlis,487,185,468,10,26,36,6,5,11,153,30,286
3/9/2021,Pulau Pinang,1985,830,1870,6,135,141,6,91,97,782,14,985
3/9/2021,Sabah,4109,1876,3931,48,193,241,35,112,147,1426,222,1494
3/9/2021,Sarawak,4055,1072,3849,229,296,525,100,227,327,587,219,2089
3/9/2021,Selangor,6302,4235,5881,131,284,415,68,317,385,1615,310,1667
3/9/2021,Terengganu,1557,491,1497,14,42,56,12,34,46,321,32,777
3/9/2021,W.P. Kuala Lumpur,4753,1606,4497,6,87,93,4,73,77,786,128,1464
3/9/2021,W.P. Labuan,122,106,99,0,0,0,0,0,0,5,3,94
3/9/2021,W.P. Putrajaya,609,168,575,8,6,14,22,10,32,59,40,236
4/9/2021,Johor,5160,2513,5000,117,249,366,62,248,310,2170,266,2212
4/9/2021,Kedah,2664,1165,2517,22,153,175,6,64,70,1049,42,1255
4/9/2021,Kelantan,2863,931,2684,20,114,134,8,88,96,741,54,1207
4/9/2021,Melaka,1315,651,1175,32,40,72,27,34,61,422,54,610
4/9/2021,Negeri Sembilan,1749,1084,1639,24,47,71,22,51,73,281,30,823
4/9/2021,Pahang,2145,719,2060,21,65,86,10,68,78,430,51,839
4/9/2021,Perak,3277,1064,3159,14,135,149,7,122,129,861,41,1710
4/9/2021,Perlis,487,185,468,23,21,44,0,5,5,150,56,271
4/9/2021,Pulau Pinang,1985,830,1870,8,129,137,5,77,82,822,15,924
4/9/2021,Sabah,4109,1780,3931,47,179,226,45,82,127,1414,245,1351
4/9/2021,Sarawak,4055,1072,3849,92,429,521,28,146,174,587,216,1964
4/9/2021,Selangor,6302,4235,5881,141,346,487,87,260,347,2174,409,1494
4/9/2021,Terengganu,1557,491,1497,12,50,62,12,25,37,350,28,821
4/9/2021,W.P. Kuala Lumpur,4753,1491,4507,2,53,55,7,91,98,728,115,1412
4/9/2021,W.P. Labuan,122,106,99,3,1,4,1,0,1,3,5,84
4/9/2021,W.P. Putrajaya,609,168,575,9,3,12,13,14,27,47,32,214
5/9/2021,Johor,5160,2511,5002,110,279,389,61,243,304,2150,245,2306
5/9/2021,Kedah,2664,1165,2517,11,116,127,3,65,68,1039,56,1295
5/9/2021,Kelantan,2863,931,2684,25,164,189,1,89,90,766,46,1306
5/9/2021,Melaka,1315,651,1175,18,48,66,20,39,59,366,42,630
5/9/2021,Negeri Sembilan,1749,1084,1639,20,47,67,22,36,58,284,27,815
5/9/2021,Pahang,2145,719,2060,15,66,81,6,29,35,466,48,831
5/9/2021,Perak,3277,1064,3159,23,144,167,1,114,115,859,51,1651
5/9/2021,Perlis,487,195,468,26,16,42,1,18,19,141,72,259
5/9/2021,Pulau Pinang,1985,830,1872,8,116,124,4,104,108,803,58,940
5/9/2021,Sabah,4109,1760,3931,37,159,196,41,79,120,1427,227,1384
5/9/2021,Sarawak,4055,1072,3849,75,335,410,64,191,255,597,211,1942
5/9/2021,Selangor,6302,4019,5889,111,254,365,76,260,336,2026,374,1567
5/9/2021,Terengganu,1557,491,1497,19,46,65,8,36,44,360,44,821
5/9/2021,W.P. Kuala Lumpur,4753,1491,4520,3,49,52,5,75,80,691,112,1495
5/9/2021,W.P. Labuan,122,106,99,0,1,1,2,0,2,3,2,75
5/9/2021,W.P. Putrajaya,609,168,575,16,7,23,10,11,21,43,37,227
6/9/2021,Johor,5160,2511,5002,123,343,466,64,258,322,2224,277,2368
6/9/2021,Kedah,2664,1165,2517,17,103,120,2,89,91,991,56,1327
6/9/2021,Kelantan,2863,931,2678,25,154,179,28,98,126,824,63,1267
6/9/2021,Melaka,1315,651,1175,24,36,60,27,40,67,391,45,646
6/9/2021,Negeri Sembilan,1749,1084,1639,11,34,45,13,30,43,298,32,811
6/9/2021,Pahang,2145,719,2060,28,28,56,6,46,52,438,68,851
6/9/2021,Perak,3277,1052,3159,16,165,181,7,90,97,880,44,1805
6/9/2021,Perlis,487,195,468,16,12,28,4,12,16,142,53,284
6/9/2021,Pulau Pinang,1985,830,1872,2,93,95,2,89,91,749,16,1069
6/9/2021,Sabah,3937,1735,3759,36,151,187,35,99,134,1404,203,1415
6/9/2021,Sarawak,4055,1072,3845,155,489,644,113,532,645,657,204,1934
6/9/2021,Selangor,6302,4019,5911,130,235,365,65,253,318,1934,421,1601
6/9/2021,Terengganu,1557,491,1497,25,35,60,7,45,52,356,58,880
6/9/2021,W.P. Kuala Lumpur,4753,1156,4520,0,55,55,5,35,40,682,126,1567
6/9/2021,W.P. Labuan,122,106,99,1,0,1,0,0,0,3,3,78
6/9/2021,W.P. Putrajaya,609,168,575,24,6,30,22,7,29,42,36,250
7/9/2021,Johor,5160,2511,5002,135,352,487,75,248,323,2255,272,2365
7/9/2021,Kedah,2664,1165,2517,15,122,137,4,69,73,967,43,1318
7/9/2021,Kelantan,2845,934,2660,33,156,189,20,108,128,824,63,1390
7/9/2021,Melaka,1315,651,1175,12,38,50,13,39,52,372,33,716
7/9/2021,Negeri Sembilan,1749,1084,1639,23,42,65,18,50,68,264,26,742
7/9/2021,Pahang,2145,719,2060,26,65,91,8,47,55,459,75,872
7/9/2021,Perak,3277,1080,3143,7,163,170,11,118,129,865,25,1828
7/9/2021,Perlis,487,195,468,40,22,62,1,16,17,134,71,271
7/9/2021,Pulau Pinang,1985,829,1872,5,98,103,4,121,125,737,17,1125
7/9/2021,Sabah,4109,1703,3931,39,165,204,63,97,160,1442,190,1604
7/9/2021,Sarawak,4055,1072,3845,147,420,567,87,250,337,675,199,1877
7/9/2021,Selangor,6302,4019,5911,130,219,349,83,263,346,1882,399,1669
7/9/2021,Terengganu,1557,491,1497,17,53,70,9,48,57,358,62,875
7/9/2021,W.P. Kuala Lumpur,4753,1156,4533,2,63,65,7,50,57,657,109,1261
7/9/2021,W.P. Labuan,122,106,99,2,0,2,1,0,1,3,4,81
7/9/2021,W.P. Putrajaya,609,140,575,21,7,28,13,7,20,41,43,239
8/9/2021,Johor,5160,2511,5002,139,299,438,71,262,333,2241,267,2358
8/9/2021,Kedah,2664,1257,2517,8,113,121,6,74,80,962,39,1383
8/9/2021,Kelantan,2845,934,2660,48,163,211,16,124,140,829,210,1303
8/9/2021,Melaka,1315,651,1175,23,32,55,19,39,58,364,37,700
8/9/2021,Negeri Sembilan,1749,1084,1639,24,54,78,26,42,68,271,27,908
8/9/2021,Pahang,2089,713,1999,14,80,94,21,57,78,457,75,825
8/9/2021,Perak,3277,1080,3143,4,177,181,7,113,120,889,15,1727
8/9/2021,Perlis,487,195,468,38,25,63,0,14,14,141,66,266
8/9/2021,Pulau Pinang,1985,829,1872,6,149,155,9,104,113,732,14,1030
8/9/2021,Sabah,4109,1725,3928,38,171,209,37,112,149,1426,159,1548
8/9/2021,Sarawak,4055,1022,3845,112,390,502,61,353,414,665,211,1921
8/9/2021,Selangor,6302,4019,5911,129,226,355,102,276,378,1843,440,1678
8/9/2021,Terengganu,1557,491,1496,16,44,60,17,56,73,327,58,883
8/9/2021,W.P. Kuala Lumpur,4753,1137,4533,1,65,66,7,58,65,629,130,1423
8/9/2021,W.P. Labuan,122,106,99,2,1,3,1,0,1,4,5,78
8/9/2021,W.P. Putrajaya,609,140,575,16,14,30,18,12,30,43,44,255
9/9/2021,Johor,5160,2538,5002,162,344,506,82,232,314,2250,302,2325
9/9/2021,Kedah,2664,1257,2517,9,135,144,2,49,51,968,55,1384
9/9/2021,Kelantan,2845,934,2660,27,177,204,10,116,126,813,62,1392
9/9/2021,Melaka,1315,651,1175,21,31,52,24,39,63,338,32,722
9/9/2021,Negeri Sembilan,1749,1084,1639,26,35,61,21,53,74,281,40,492
9/9/2021,Pahang,2089,713,1999,16,49,65,9,26,35,460,76,872
9/9/2021,Perak,3277,1080,3143,3,172,175,2,120,122,896,7,1832
9/9/2021,Perlis,487,195,468,35,17,52,21,10,31,131,64,257
9/9/2021,Pulau Pinang,1985,829,1872,5,137,142,4,127,131,741,14,694
9/9/2021,Sabah,4109,1779,3924,41,173,214,30,79,109,1419,181,1562
9/9/2021,Sarawak,4055,1022,3845,140,546,686,86,477,563,658,235,1984
9/9/2021,Selangor,6302,3537,5911,102,238,340,80,257,337,1718,389,1778
9/9/2021,Terengganu,1557,491,1496,19,46,65,12,32,44,334,69,921
9/9/2021,W.P. Kuala Lumpur,4753,1137,4533,1,34,35,3,53,56,574,99,1459
9/9/2021,W.P. Labuan,122,106,99,0,3,3,3,0,3,7,0,81
9/9/2021,W.P. Putrajaya,609,140,575,26,15,41,18,9,27,49,50,256
10/9/2021,Johor,5160,2538,4992,154,372,526,79,210,289,2271,315,2310
10/9/2021,Kedah,2664,1257,2517,1,136,137,7,101,108,912,33,1321
10/9/2021,Kelantan,2845,934,2660,29,172,201,28,119,147,817,59,1331
10/9/2021,Melaka,1315,651,1175,24,38,62,26,37,63,334,30,787
10/9/2021,Negeri Sembilan,1749,1084,1639,31,55,86,23,37,60,295,47,807
10/9/2021,Pahang,2089,713,1999,21,58,79,22,39,61,449,68,872
10/9/2021,Perak,3277,1080,3143,4,188,192,1,121,122,895,13,1803
10/9/2021,Perlis,487,195,468,11,24,35,0,14,14,132,54,274
10/9/2021,Pulau Pinang,1985,829,1872,2,106,108,1,78,79,751,15,994
10/9/2021,Sabah,4109,1726,3924,36,142,178,49,118,167,1381,170,1542
10/9/2021,Sarawak,4055,1022,3845,126,483,609,105,478,583,666,195,1918
10/9/2021,Selangor,6302,3537,5916,124,215,339,117,160,277,1659,344,1758
10/9/2021,Terengganu,1557,491,1496,13,44,57,17,39,56,338,65,819
10/9/2021,W.P. Kuala Lumpur,4753,1049,4533,1,54,55,2,64,66,543,110,1468
10/9/2021,W.P. Labuan,122,106,99,0,0,0,0,0,0,6,0,83
10/9/2021,W.P. Putrajaya,609,140,575,23,6,29,19,11,30,43,43,287
11/9/2021,Johor,5160,2538,4992,129,277,406,67,230,297,2282,304,2289
11/9/2021,Kedah,2664,1257,2517,10,104,114,0,56,56,952,25,1350
11/9/2021,Kelantan,2845,934,2660,36,178,214,14,107,121,841,57,1291
11/9/2021,Melaka,1315,651,1175,32,38,70,8,38,46,263,15,677
11/9/2021,Negeri Sembilan,1749,1084,1639,26,60,86,22,52,74,305,28,757
11/9/2021,Pahang,2089,713,1999,15,51,66,12,47,59,443,69,858
11/9/2021,Perak,3277,1080,3143,2,158,160,0,113,113,885,14,1763
11/9/2021,Perlis,487,195,468,19,24,43,13,17,30,139,57,263
11/9/2021,Pulau Pinang,1985,830,1872,2,116,118,3,87,90,717,7,978
11/9/2021,Sabah,4109,1726,3924,49,160,209,35,97,132,1335,173,1503
11/9/2021,Sarawak,4055,1022,3845,154,530,684,102,557,659,648,196,1869
11/9/2021,Selangor,6302,3537,5916,269,276,545,78,279,357,1599,398,1722
11/9/2021,Terengganu,1557,491,1496,15,58,73,19,30,49,360,52,848
11/9/2021,W.P. Kuala Lumpur,4753,1022,4533,0,55,55,4,74,78,509,98,1285
11/9/2021,W.P. Labuan,122,106,99,0,0,0,0,0,0,6,0,81
11/9/2021,W.P. Putrajaya,609,140,581,26,9,35,20,11,31,41,46,274
12/9/2021,Johor,5160,2538,4992,121,284,405,104,215,319,2316,290,2346
12/9/2021,Kedah,2664,1257,2517,15,91,106,4,62,66,955,21,1344
12/9/2021,Kelantan,2845,934,2660,24,173,197,19,107,126,874,51,1337
12/9/2021,Melaka,1315,651,1175,23,27,50,17,37,54,297,44,720
12/9/2021,Negeri Sembilan,1749,1084,1639,23,65,88,20,28,48,308,23,725
12/9/2021,Pahang,2066,713,1976,15,54,69,17,60,77,464,64,839
12/9/2021,Perak,3277,1080,3143,8,160,168,2,92,94,890,19,1785
12/9/2021,Perlis,487,195,468,24,18,42,3,3,6,132,58,300
12/9/2021,Pulau Pinang,1985,830,1872,3,145,148,2,92,94,752,14,978
12/9/2021,Sabah,4109,1770,3924,26,156,182,31,88,119,1324,168,1445
12/9/2021,Sarawak,4055,1022,3845,119,465,584,74,658,732,660,231,1784
12/9/2021,Selangor,6302,3537,5931,126,180,306,100,205,305,1635,378,1813
12/9/2021,Terengganu,1557,491,1497,27,44,71,12,62,74,348,64,871
12/9/2021,W.P. Kuala Lumpur,4753,1022,4533,1,62,63,6,47,53,502,72,1291
12/9/2021,W.P. Labuan,122,106,99,2,0,2,0,0,0,5,2,71
12/9/2021,W.P. Putrajaya,609,112,581,23,4,27,13,14,27,30,52,262
13/9/2021,Johor,5160,2538,4992,144,267,411,92,281,373,2233,275,2333
13/9/2021,Kedah,2664,1257,2517,10,113,123,2,62,64,907,52,1399
13/9/2021,Kelantan,2845,938,2663,25,178,203,5,180,185,845,70,1375
13/9/2021,Melaka,1315,651,1175,29,38,67,14,5,19,333,34,700
13/9/2021,Negeri Sembilan,1749,1084,1639,21,30,51,21,42,63,317,44,852
13/9/2021,Pahang,2066,713,1976,13,49,62,10,47,57,456,57,859
13/9/2021,Perak,3277,1080,3143,6,139,145,2,90,92,909,20,1774
13/9/2021,Perlis,487,195,468,20,16,36,6,13,19,124,50,316
13/9/2021,Pulau Pinang,1985,830,1867,3,105,108,3,92,95,742,14,873
13/9/2021,Sabah,4109,1766,3926,34,119,153,44,84,128,1320,167,1515
13/9/2021,Sarawak,4055,1022,3845,87,436,523,93,398,491,694,162,1830
13/9/2021,Selangor,6302,3377,5931,111,178,289,75,142,217,1519,398,1832
13/9/2021,Terengganu,1557,491,1497,14,68,82,14,102,116,320,53,924
13/9/2021,W.P. Kuala Lumpur,4753,973,4550,2,49,51,7,38,45,499,88,1457
13/9/2021,W.P. Labuan,122,106,99,0,0,0,1,0,1,6,1,71
13/9/2021,W.P. Putrajaya,609,112,581,26,1,27,25,3,28,28,51,273
14/9/2021,Johor,5160,2538,4992,161,241,402,71,172,243,2258,299,2407
14/9/2021,Kedah,2664,1257,2517,8,89,97,1,96,97,866,14,1345
14/9/2021,Kelantan,2845,938,2663,31,163,194,19,108,127,852,70,1337
14/9/2021,Melaka,1315,651,1175,11,29,40,5,37,42,318,24,681
14/9/2021,Negeri Sembilan,1749,1084,1639,25,40,65,19,49,68,286,38,849
14/9/2021,Pahang,2066,713,1976,24,77,101,19,51,70,481,66,840
14/9/2021,Perak,3277,1080,3143,10,160,170,8,114,122,837,19,1778
14/9/2021,Perlis,487,195,468,50,17,67,2,11,13,115,54,335
14/9/2021,Pulau Pinang,1985,830,1867,6,104,110,4,100,104,741,16,1019
14/9/2021,Sabah,4109,1766,3926,45,152,197,29,111,140,1312,171,1576
14/9/2021,Sarawak,4055,1022,3845,127,249,376,81,306,387,691,198,1913
14/9/2021,Selangor,6302,3377,5931,141,200,341,81,246,327,1445,427,1906
14/9/2021,Terengganu,1557,491,1481,12,52,64,10,67,77,305,51,942
14/9/2021,W.P. Kuala Lumpur,4753,973,4580,5,50,55,11,46,57,467,63,1396
14/9/2021,W.P. Labuan,122,106,99,0,1,1,0,0,0,7,1,75
14/9/2021,W.P. Putrajaya,609,112,581,16,4,20,14,4,18,28,48,273
15/9/2021,Johor,5160,2566,4991,142,271,413,74,221,295,2190,255,2449
15/9/2021,Kedah,2664,1257,2517,10,104,114,11,82,93,796,42,1419
15/9/2021,Kelantan,2845,938,2663,20,154,174,15,131,146,845,65,1297
15/9/2021,Melaka,1315,651,1175,18,20,38,18,35,53,304,43,705
15/9/2021,Negeri Sembilan,1749,1084,1639,14,57,71,17,34,51,301,19,808
15/9/2021,Pahang,2066,713,1976,16,48,64,12,50,62,477,62,860
15/9/2021,Perak,3277,1080,3143,8,163,171,1,111,112,864,26,1833
15/9/2021,Perlis,487,223,468,18,18,36,11,7,18,118,53,339
15/9/2021,Pulau Pinang,1985,830,1867,5,127,132,2,102,104,750,18,1011
15/9/2021,Sabah,4109,1711,3870,47,145,192,35,81,116,1268,176,1589
15/9/2021,Sarawak,4055,1058,3845,125,435,560,80,388,468,732,194,1894
15/9/2021,Selangor,6302,3377,5931,111,171,282,106,239,345,1330,382,2106
15/9/2021,Terengganu,1557,491,1481,18,46,64,10,63,73,288,52,930
15/9/2021,W.P. Kuala Lumpur,4753,958,4580,6,54,60,5,48,53,441,73,1488
15/9/2021,W.P. Labuan,122,106,99,3,1,4,0,0,0,8,4,73
15/9/2021,W.P. Putrajaya,609,112,581,19,3,22,10,5,15,25,54,284
16/9/2021,Johor,5160,2753,4991,86,251,337,63,261,324,2014,156,2395
16/9/2021,Kedah,2664,1257,2517,9,108,117,7,78,85,807,33,1304
16/9/2021,Kelantan,2845,938,2663,29,153,182,2,103,105,839,72,1296
16/9/2021,Melaka,1315,651,1187,26,28,54,15,39,54,314,37,698
16/9/2021,Negeri Sembilan,1749,1084,1639,22,43,65,12,51,63,288,18,803
16/9/2021,Pahang,2066,713,1976,30,53,83,7,73,80,473,69,825
16/9/2021,Perak,3277,1080,3143,2,147,149,10,127,137,838,16,1786
16/9/2021,Perlis,487,211,468,20,15,35,9,10,19,112,52,351
16/9/2021,Pulau Pinang,1985,830,1867,3,117,120,7,115,122,727,14,959
16/9/2021,Sabah,3937,1682,3698,42,119,161,39,107,146,1177,161,1563
16/9/2021,Sarawak,4055,1058,3845,125,327,452,38,264,302,734,215,1888
16/9/2021,Selangor,6302,3088,5931,161,208,369,101,115,216,1437,397,2010
16/9/2021,Terengganu,1557,491,1481,18,66,84,18,58,76,297,42,890
16/9/2021,W.P. Kuala Lumpur,4753,958,4580,2,50,52,3,45,48,449,66,1455
16/9/2021,W.P. Labuan,122,106,99,0,0,0,0,0,0,5,4,71
16/9/2021,W.P. Putrajaya,609,112,581,11,2,13,21,2,23,26,44,290
17/9/2021,Johor,5160,2753,4991,86,227,313,94,221,315,2011,139,2460
17/9/2021,Kedah,2664,1257,2517,12,85,97,7,60,67,759,34,1351
17/9/2021,Kelantan,2845,938,2663,27,153,180,20,110,130,854,78,1269
17/9/2021,Melaka,1315,651,1187,10,24,34,15,34,49,267,35,737
17/9/2021,Negeri Sembilan,1749,1084,1639,14,57,71,25,12,37,302,9,812
17/9/2021,Pahang,2066,713,1976,7,65,72,27,55,82,468,42,822
17/9/2021,Perak,3277,1080,3143,9,141,150,5,67,72,847,24,1876
17/9/2021,Perlis,487,211,468,21,19,40,5,7,12,123,51,315
17/9/2021,Pulau Pinang,1985,830,1867,0,109,109,6,78,84,750,6,942
17/9/2021,Sabah,4109,1698,3870,32,129,161,41,106,147,1175,146,1620
17/9/2021,Sarawak,4055,1058,3845,103,355,458,52,240,292,753,212,1837
17/9/2021,Selangor,6302,3088,5931,222,159,381,142,147,289,1324,334,2161
17/9/2021,Terengganu,1557,491,1481,5,62,67,21,34,55,308,28,887
17/9/2021,W.P. Kuala Lumpur,4753,958,4580,0,39,39,4,24,28,444,60,1507
17/9/2021,W.P. Labuan,122,106,99,0,0,0,0,0,0,5,4,72
17/9/2021,W.P. Putrajaya,609,112,581,25,3,28,19,3,22,24,45,302
18/9/2021,Johor,5160,2753,4991,98,191,289,55,195,250,1969,154,2349
18/9/2021,Kedah,2664,1257,2517,4,87,91,3,82,85,720,26,1281
18/9/2021,Kelantan,2845,938,2663,14,145,159,8,82,90,852,67,1294
18/9/2021,Melaka,1315,651,1187,33,27,60,12,30,42,283,34,693
18/9/2021,Negeri Sembilan,1749,1084,1639,19,40,59,14,48,62,275,23,792
18/9/2021,Pahang,2066,713,1976,13,54,67,8,36,44,447,40,794
18/9/2021,Perak,3277,1080,3143,6,159,165,2,138,140,793,17,1769
18/9/2021,Perlis,487,211,468,10,10,20,9,9,18,123,39,304
18/9/2021,Pulau Pinang,1985,830,1867,2,91,93,3,113,116,720,5,927
18/9/2021,Sabah,4109,1698,3870,27,134,161,44,96,140,1156,132,1645
18/9/2021,Sarawak,4055,1058,3845,142,305,447,52,293,345,777,215,1827
18/9/2021,Selangor,6302,3088,5931,127,132,259,78,208,286,1241,372,1950
18/9/2021,Terengganu,1557,491,1481,13,46,59,8,47,55,323,31,794
18/9/2021,W.P. Kuala Lumpur,4753,958,4580,0,47,47,6,37,43,433,50,1433
18/9/2021,W.P. Labuan,122,106,99,0,0,0,0,0,0,3,4,68
18/9/2021,W.P. Putrajaya,609,112,581,17,4,21,20,3,23,25,40,279
19/9/2021,Johor,5160,2753,4991,87,200,287,91,189,280,1959,132,2520
19/9/2021,Kedah,2664,1257,2517,4,78,82,5,37,42,720,25,1375
19/9/2021,Kelantan,2845,938,2663,15,140,155,13,86,99,872,53,1408
19/9/2021,Melaka,1315,651,1187,16,25,41,18,29,47,247,7,683
19/9/2021,Negeri Sembilan,1749,1084,1639,12,36,48,14,48,62,258,23,955
19/9/2021,Pahang,2066,713,1976,10,49,59,9,31,40,467,44,850
19/9/2021,Perak,3277,1090,3143,10,157,167,3,95,98,833,25,1697
19/9/2021,Perlis,487,211,468,19,16,35,5,4,9,125,42,281
19/9/2021,Pulau Pinang,1985,830,1867,2,105,107,1,110,111,743,7,907
19/9/2021,Sabah,4109,1698,3870,21,111,132,18,90,108,1116,118,1584
19/9/2021,Sarawak,4055,1110,3845,62,263,325,63,292,355,785,208,1760
19/9/2021,Selangor,6302,3065,5931,149,133,282,120,143,263,1156,397,2071
19/9/2021,Terengganu,1557,491,1481,14,38,52,5,45,50,317,33,873
19/9/2021,W.P. Kuala Lumpur,4753,958,4580,1,41,42,6,28,34,428,44,1433
19/9/2021,W.P. Labuan,122,106,99,0,1,1,0,0,0,4,4,76
19/9/2021,W.P. Putrajaya,609,112,581,29,6,35,23,3,26,28,44,302
20/9/2021,Johor,5160,2753,5002,78,216,294,87,215,302,1937,135,2560
20/9/2021,Kedah,2664,1257,2546,8,73,81,1,72,73,711,25,1390
20/9/2021,Kelantan,2845,938,2659,10,161,171,5,123,128,846,43,1465
20/9/2021,Melaka,1315,651,1187,14,20,34,9,14,23,249,39,712
20/9/2021,Negeri Sembilan,1749,1084,1639,13,36,49,13,61,74,232,24,707
20/9/2021,Pahang,2066,709,1960,8,45,53,7,20,27,456,32,902
20/9/2021,Perak,3277,1090,3143,4,125,129,2,83,85,806,29,1727
20/9/2021,Perlis,487,211,468,13,12,25,5,8,13,129,35,270
20/9/2021,Pulau Pinang,1985,830,1867,4,95,99,4,97,101,700,7,953
20/9/2021,Sabah,4109,1698,3894,34,166,200,21,59,80,1111,127,1561
20/9/2021,Sarawak,4055,1110,3845,61,352,413,72,390,462,797,147,1831
20/9/2021,Selangor,6302,2800,5936,124,156,280,93,164,257,1408,418,2092
20/9/2021,Terengganu,1557,491,1490,19,41,60,5,44,49,302,39,930
20/9/2021,W.P. Kuala Lumpur,4753,834,4570,2,24,26,2,24,26,418,25,1490
20/9/2021,W.P. Labuan,122,106,99,1,0,1,0,0,0,4,5,79
20/9/2021,W.P. Putrajaya,609,112,585,18,5,23,11,5,16,29,50,307
21/9/2021,Johor,5160,2753,5002,107,196,303,65,240,305,1874,131,2608
21/9/2021,Kedah,2664,1257,2546,12,66,78,1,84,85,633,30,1429
21/9/2021,Kelantan,2935,958,2753,18,144,162,8,121,129,857,47,1426
21/9/2021,Melaka,1315,651,1181,7,22,29,14,26,40,249,35,789
21/9/2021,Negeri Sembilan,1749,1084,1639,21,17,38,15,34,49,193,30,738
21/9/2021,Pahang,2066,709,1958,14,55,69,12,55,67,449,35,951
21/9/2021,Perak,3277,1090,3143,9,126,135,0,79,79,759,30,1348
21/9/2021,Perlis,487,211,468,27,21,48,1,18,19,114,37,188
21/9/2021,Pulau Pinang,1985,830,1867,5,102,107,0,113,113,673,11,969
21/9/2021,Sabah,4109,1702,3880,29,107,136,35,101,136,1066,114,1584
21/9/2021,Sarawak,4055,1110,3844,72,335,407,92,617,709,816,129,1876
21/9/2021,Selangor,6302,2800,5952,106,169,275,152,170,322,1104,308,2211
21/9/2021,Terengganu,1557,491,1493,17,42,59,6,50,56,300,49,914
21/9/2021,W.P. Kuala Lumpur,4753,834,4579,2,40,42,8,34,42,416,49,1474
21/9/2021,W.P. Labuan,122,106,99,0,1,1,1,0,1,2,3,71
21/9/2021,W.P. Putrajaya,609,112,585,12,3,15,27,7,34,25,32,304
22/9/2021,Johor,5160,2753,5002,80,223,303,68,253,321,1785,139,2668
22/9/2021,Kedah,2664,1257,2546,14,66,80,4,71,75,601,35,1465
22/9/2021,Kelantan,2935,958,2749,23,167,190,3,139,142,842,47,1492
22/9/2021,Melaka,1315,651,1187,34,18,52,13,26,39,232,39,743
22/9/2021,Negeri Sembilan,1749,1084,1639,11,31,42,13,35,48,216,32,801
22/9/2021,Pahang,2066,709,1958,21,40,61,9,63,72,419,49,951
22/9/2021,Perak,3277,1090,3141,7,160,167,5,108,113,748,31,1802
22/9/2021,Perlis,487,211,468,19,20,39,3,18,21,108,42,187
22/9/2021,Pulau Pinang,1985,830,1867,2,100,102,4,114,118,635,7,960
22/9/2021,Sabah,4109,1702,3887,20,110,130,28,88,116,1021,107,1621
22/9/2021,Sarawak,4055,1110,3844,118,382,500,52,243,295,791,176,1869
22/9/2021,Selangor,6302,2802,5953,178,118,296,114,149,263,1012,427,2187
22/9/2021,Terengganu,1557,491,1493,14,48,62,20,48,68,302,39,922
22/9/2021,W.P. Kuala Lumpur,4753,847,4579,0,40,40,5,23,28,336,42,1533
22/9/2021,W.P. Labuan,122,106,99,0,0,0,1,0,1,2,2,67
22/9/2021,W.P. Putrajaya,609,112,585,16,6,22,15,6,21,25,32,289
