date,state,beds,admitted_pui,admitted_covid,admitted_total,discharge_pui,discharge_covid,discharge_total,pkrc_covid,pkrc_pui,pkrc_noncovid
1/1/2021,Johor,1879,0,97,97,49,29,78,1550,0,0
1/1/2021,Kedah,699,0,26,26,0,8,8,26,0,0
1/1/2021,Kelantan,117,2,9,11,3,0,3,34,5,1
1/1/2021,Melaka,306,0,35,35,0,9,9,189,4,4
1/1/2021,Negeri Sembilan,1661,0,42,42,0,41,41,248,0,0
1/1/2021,Pahang,550,0,295,295,0,4,4,305,0,16
1/1/2021,Perak,851,0,26,26,0,7,7,196,0,0
1/1/2021,Perlis,33,0,0,0,0,0,0,0,0,0
1/1/2021,Pulau Pinang,633,0,194,194,0,44,44,483,0,0
1/1/2021,Sabah,5445,9,246,255,2,208,210,1091,42,0
1/1/2021,Sarawak,963,2,0,2,0,0,0,12,5,66
1/1/2021,Selangor,9477,5,1355,1360,5,1495,1500,5101,11,40
1/1/2021,Terengganu,48,0,0,0,0,0,0,0,0,0
1/1/2021,W.P. Labuan,420,0,37,37,1,6,7,85,48,0
2/1/2021,Johor,1885,0,83,83,0,147,147,1364,0,0
2/1/2021,Kedah,372,0,15,15,0,1,1,29,0,0
2/1/2021,Kelantan,305,6,13,19,3,5,8,42,8,4
2/1/2021,Melaka,306,0,4,4,0,3,3,190,4,4
2/1/2021,Negeri Sembilan,1661,0,21,21,0,80,80,186,0,0
2/1/2021,Pahang,550,0,3,3,0,1,1,307,0,35
2/1/2021,Perak,851,0,9,9,0,15,15,190,0,0
2/1/2021,Perlis,33,0,0,0,0,0,0,0,0,0
2/1/2021,Pulau Pinang,965,0,251,251,0,31,31,614,0,0
2/1/2021,Sabah,5445,5,185,190,2,165,167,1099,43,0
2/1/2021,Sarawak,963,1,0,1,0,0,0,13,6,71
2/1/2021,Selangor,10191,0,1442,1442,2,1071,1073,5472,0,40
2/1/2021,Terengganu,48,0,0,0,0,0,0,0,0,0
2/1/2021,W.P. Labuan,420,3,11,14,1,15,16,71,50,0
3/1/2021,Johor,1917,0,24,24,0,242,242,1209,0,0
3/1/2021,Kedah,372,0,31,31,0,2,2,63,0,0
3/1/2021,Kelantan,305,4,23,27,2,5,7,60,10,4
3/1/2021,Melaka,310,1,72,73,0,112,112,150,5,0
3/1/2021,Negeri Sembilan,1661,0,30,30,0,40,40,175,0,0
3/1/2021,Pahang,578,0,8,8,0,0,0,315,0,30
3/1/2021,Perak,851,1,47,48,0,34,34,203,1,99
3/1/2021,Perlis,33,0,0,0,0,0,0,0,0,0
3/1/2021,Pulau Pinang,965,0,40,40,0,29,29,698,0,0
3/1/2021,Sabah,5445,4,197,201,6,183,189,1109,42,0
3/1/2021,Sarawak,293,2,0,2,2,0,2,13,6,73
3/1/2021,Selangor,9767,16,854,870,0,1559,1559,4767,25,40
3/1/2021,Terengganu,48,0,0,0,0,0,0,0,0,0
3/1/2021,W.P. Labuan,420,19,0,19,0,8,8,62,69,0
4/1/2021,Johor,1979,0,102,102,0,248,248,1146,0,0
4/1/2021,Kedah,372,0,40,40,0,6,6,97,0,0
4/1/2021,Kelantan,305,6,12,18,3,13,16,59,13,2
4/1/2021,Melaka,310,0,7,7,4,18,22,139,1,0
4/1/2021,Negeri Sembilan,1661,0,7,7,0,38,38,144,0,0
4/1/2021,Pahang,578,0,0,0,0,0,0,315,0,34
4/1/2021,Perak,851,2,35,37,0,29,29,180,4,133
4/1/2021,Perlis,33,0,0,0,0,0,0,0,0,0
4/1/2021,Pulau Pinang,1055,0,34,34,0,14,14,663,0,0
4/1/2021,Sabah,5445,13,303,316,13,103,116,1306,41,0
4/1/2021,Sarawak,963,3,0,3,3,0,3,24,6,84
4/1/2021,Selangor,8409,0,741,741,2,582,584,4926,23,40
4/1/2021,Terengganu,48,0,0,0,0,0,0,0,0,0
4/1/2021,W.P. Labuan,420,0,8,8,0,8,8,71,61,0
5/1/2021,Johor,2546,0,63,63,0,150,150,1701,0,0
5/1/2021,Kedah,372,0,1,1,0,6,6,92,0,0
5/1/2021,Kelantan,305,9,28,37,1,11,12,76,21,7
5/1/2021,Melaka,310,0,6,6,0,13,13,132,1,1
5/1/2021,Negeri Sembilan,1661,0,82,82,0,13,13,210,0,0
5/1/2021,Pahang,578,0,3,3,0,4,4,314,0,46
5/1/2021,Perak,901,0,18,18,0,20,20,207,4,90
5/1/2021,Perlis,33,0,0,0,0,0,0,0,0,0
5/1/2021,Pulau Pinang,1055,0,25,25,0,29,29,758,0,0
5/1/2021,Sabah,5481,5,253,258,14,147,161,1433,43,0
5/1/2021,Sarawak,963,2,0,2,2,0,2,33,6,97
5/1/2021,Selangor,11345,5,741,746,1,937,938,4735,27,40
5/1/2021,Terengganu,48,0,0,0,0,0,0,0,0,0
5/1/2021,W.P. Labuan,420,1,0,1,2,11,13,60,60,0
6/1/2021,Johor,2638,0,47,47,0,142,142,1768,0,0
6/1/2021,Kedah,572,0,33,33,0,9,9,116,0,0
6/1/2021,Kelantan,305,8,24,32,3,8,11,92,26,9
6/1/2021,Melaka,310,1,23,24,0,12,12,143,2,0
6/1/2021,Negeri Sembilan,1661,0,52,52,0,41,41,221,0,0
6/1/2021,Pahang,578,0,8,8,0,0,0,322,0,64
6/1/2021,Perak,913,0,28,28,0,21,21,217,1,92
6/1/2021,Perlis,33,0,0,0,0,0,0,0,0,0
6/1/2021,Pulau Pinang,1055,0,43,43,0,37,37,754,0,0
6/1/2021,Sabah,5531,8,344,352,4,125,129,1642,48,0
6/1/2021,Sarawak,963,1,0,1,0,0,0,34,7,102
6/1/2021,Selangor,11345,23,1078,1101,5,689,694,5126,43,40
6/1/2021,Terengganu,48,0,0,0,0,0,0,0,0,0
6/1/2021,W.P. Labuan,420,0,22,22,4,23,27,73,29,0
7/1/2021,Johor,3732,0,79,79,0,488,488,2519,0,0
7/1/2021,Kedah,572,0,63,63,0,12,12,167,0,0
7/1/2021,Kelantan,425,16,27,43,12,22,34,97,30,9
7/1/2021,Melaka,310,6,11,17,1,18,19,136,7,0
7/1/2021,Negeri Sembilan,1661,0,14,14,0,15,15,220,0,0
7/1/2021,Pahang,578,2,1,3,0,13,13,310,2,50
7/1/2021,Perak,913,0,25,25,0,30,30,211,0,90
7/1/2021,Perlis,33,0,0,0,0,0,0,0,0,0
7/1/2021,Pulau Pinang,1055,0,20,20,0,171,171,603,0,0
7/1/2021,Sabah,5557,8,264,272,8,160,168,1747,49,0
7/1/2021,Sarawak,963,0,0,0,3,0,3,35,4,104
7/1/2021,Selangor,9998,4,1625,1629,7,1579,1586,5172,40,40
7/1/2021,Terengganu,48,0,0,0,0,0,0,0,0,0
7/1/2021,W.P. Labuan,393,0,0,0,0,10,10,72,22,0
8/1/2021,Johor,4072,0,37,37,0,190,190,2955,0,0
8/1/2021,Kedah,572,0,19,19,0,27,27,162,0,0
8/1/2021,Kelantan,425,10,59,69,14,7,21,149,26,11
8/1/2021,Melaka,270,0,44,44,2,12,14,168,5,5
8/1/2021,Negeri Sembilan,1661,0,55,55,0,23,23,252,0,0
8/1/2021,Pahang,578,0,4,4,0,3,3,311,2,46
8/1/2021,Perak,913,0,73,73,0,31,31,250,4,91
8/1/2021,Perlis,33,0,0,0,0,0,0,0,0,0
8/1/2021,Pulau Pinang,1205,0,43,43,0,139,139,453,0,0
8/1/2021,Sabah,5487,5,337,342,4,294,298,1787,45,0
8/1/2021,Sarawak,315,2,0,2,1,0,1,44,5,92
8/1/2021,Selangor,9998,13,711,724,11,1264,1275,4619,42,40
8/1/2021,Terengganu,68,0,7,7,0,0,0,7,0,0
8/1/2021,W.P. Labuan,393,8,4,12,0,20,20,55,30,0
9/1/2021,Johor,4072,0,37,37,0,152,152,2955,0,0
9/1/2021,Kedah,572,4,104,108,0,17,17,242,4,0
9/1/2021,Kelantan,425,26,3,29,8,16,24,98,82,10
9/1/2021,Melaka,262,0,63,63,7,22,29,217,0,0
9/1/2021,Negeri Sembilan,1530,0,61,61,0,52,52,259,0,0
9/1/2021,Pahang,578,0,16,16,0,6,6,321,2,54
9/1/2021,Perak,913,0,16,16,0,40,40,227,3,84
9/1/2021,Perlis,33,0,0,0,0,0,0,6,0,0
9/1/2021,Pulau Pinang,1205,0,75,75,0,191,191,405,0,0
9/1/2021,Sabah,5557,5,351,356,2,266,268,1885,49,0
9/1/2021,Sarawak,985,2,0,2,2,0,2,58,5,90
9/1/2021,Selangor,9998,12,762,774,5,1279,1284,4102,49,40
9/1/2021,Terengganu,68,0,0,0,0,2,2,5,0,0
9/1/2021,W.P. Labuan,393,6,5,11,0,7,7,53,36,0
10/1/2021,Johor,4251,0,111,111,0,123,123,2989,0,0
10/1/2021,Kedah,572,0,39,39,0,19,19,265,4,0
10/1/2021,Kelantan,425,7,36,43,3,28,31,153,39,13
10/1/2021,Melaka,262,0,5,5,0,32,32,189,0,0
10/1/2021,Negeri Sembilan,1530,0,25,25,0,26,26,256,0,0
10/1/2021,Pahang,578,0,1,1,2,2,4,320,0,60
10/1/2021,Perak,913,0,49,49,0,32,32,242,2,107
10/1/2021,Perlis,33,0,2,2,0,0,0,11,0,0
10/1/2021,Pulau Pinang,1205,0,140,140,0,186,186,403,0,0
10/1/2021,Sabah,5568,8,306,314,4,280,284,1975,41,0
10/1/2021,Sarawak,985,1,0,1,0,0,0,78,6,76
10/1/2021,Selangor,9998,22,863,885,20,1818,1838,3147,51,40
10/1/2021,Terengganu,236,0,6,6,0,0,0,11,0,0
10/1/2021,W.P. Labuan,393,6,0,6,4,8,12,46,39,0
11/1/2021,Johor,4251,0,116,116,0,442,442,2735,0,0
11/1/2021,Kedah,572,0,48,48,0,49,49,263,3,0
11/1/2021,Kelantan,425,10,52,62,17,41,58,164,32,13
11/1/2021,Melaka,262,0,8,8,1,7,8,193,2,2
11/1/2021,Negeri Sembilan,1740,0,323,323,0,73,73,486,0,0
11/1/2021,Pahang,590,1,2,3,0,84,84,238,1,151
11/1/2021,Perak,913,0,31,31,0,41,41,230,2,118
11/1/2021,Perlis,33,0,2,2,0,0,0,14,0,0
11/1/2021,Pulau Pinang,1205,0,59,59,0,83,83,344,0,0
11/1/2021,Sabah,5588,11,314,325,3,301,304,1984,54,0
11/1/2021,Sarawak,985,2,0,2,1,0,1,83,7,82
11/1/2021,Selangor,9698,6,890,896,6,507,513,3530,51,40
11/1/2021,Terengganu,236,0,14,14,0,0,0,25,0,0
11/1/2021,W.P. Labuan,393,5,4,9,0,11,11,50,38,0
12/1/2021,Johor,4251,0,112,112,0,245,245,2651,0,0
12/1/2021,Kedah,572,4,32,36,0,9,9,286,7,0
12/1/2021,Kelantan,425,8,48,56,2,24,26,188,38,12
12/1/2021,Melaka,262,4,3,7,0,82,82,116,12,0
12/1/2021,Negeri Sembilan,1801,0,126,126,0,46,46,585,0,0
12/1/2021,Pahang,590,0,10,10,0,27,27,221,1,139
12/1/2021,Perak,1033,0,229,229,0,30,30,427,2,103
12/1/2021,Perlis,33,0,0,0,0,1,1,14,0,0
12/1/2021,Pulau Pinang,1205,0,121,121,0,110,110,378,0,0
12/1/2021,Sabah,5756,6,265,271,10,205,215,2059,47,0
12/1/2021,Sarawak,1065,2,0,2,1,0,1,112,7,92
12/1/2021,Selangor,9698,16,799,815,10,639,649,3690,57,40
12/1/2021,Terengganu,266,0,24,24,0,1,1,48,0,0
12/1/2021,W.P. Labuan,393,8,3,11,1,23,24,36,46,0
13/1/2021,Johor,4251,0,157,157,0,186,186,2450,0,0
13/1/2021,Kedah,572,1,63,64,2,27,29,315,7,0
13/1/2021,Kelantan,387,25,24,49,11,22,33,83,159,11
13/1/2021,Melaka,268,11,7,18,0,11,11,116,10,0
13/1/2021,Negeri Sembilan,1301,0,62,62,0,54,54,592,0,0
13/1/2021,Pahang,500,0,71,71,0,86,86,170,0,0
13/1/2021,Perak,713,0,34,34,0,17,17,443,3,111
13/1/2021,Perlis,33,1,0,1,0,1,1,13,0,0
13/1/2021,Pulau Pinang,1205,0,100,100,0,98,98,378,0,0
13/1/2021,Sabah,5796,13,334,347,4,268,272,2042,55,0
13/1/2021,Sarawak,1107,1,0,1,0,0,0,120,9,103
13/1/2021,Selangor,9698,9,907,916,2,520,522,4074,64,40
13/1/2021,Terengganu,266,0,33,33,0,2,2,79,0,0
13/1/2021,W.P. Labuan,393,18,0,18,0,2,2,47,63,0
14/1/2021,Johor,3384,0,60,60,0,1138,1138,1192,0,0
14/1/2021,Kedah,572,0,65,65,0,29,29,354,6,0
14/1/2021,Kelantan,387,8,34,42,6,20,26,215,42,12
14/1/2021,Melaka,268,0,4,4,6,9,15,111,4,4
14/1/2021,Negeri Sembilan,1301,0,56,56,0,19,19,625,0,0
14/1/2021,Pahang,500,0,107,107,0,55,55,222,0,0
14/1/2021,Perak,753,0,42,42,0,18,18,467,2,124
14/1/2021,Perlis,33,0,0,0,0,4,4,11,1,0
14/1/2021,Pulau Pinang,1205,0,77,77,0,135,135,353,0,0
14/1/2021,Sabah,5818,13,316,329,4,282,286,2130,69,0
14/1/2021,Sarawak,1190,4,0,4,3,0,3,295,11,100
14/1/2021,Selangor,9698,3,773,776,7,819,826,4028,60,40
14/1/2021,Terengganu,266,0,21,21,0,4,4,96,0,0
14/1/2021,W.P. Labuan,393,4,0,4,0,4,4,45,52,0
15/1/2021,Johor,3384,0,96,96,0,396,396,1084,0,0
15/1/2021,Kedah,572,0,84,84,2,131,133,302,1,0
15/1/2021,Kelantan,387,6,35,41,14,29,43,221,34,19
15/1/2021,Melaka,268,1,20,21,0,16,16,128,1,1
15/1/2021,Negeri Sembilan,1301,0,77,77,0,52,52,647,0,0
15/1/2021,Pahang,722,0,88,88,0,42,42,268,0,0
15/1/2021,Perak,753,0,86,86,0,35,35,518,2,185
15/1/2021,Perlis,114,1,0,1,0,0,0,12,0,0
15/1/2021,Pulau Pinang,1205,0,56,56,0,85,85,332,0,0
15/1/2021,Sabah,5697,8,274,282,10,340,350,2074,55,0
15/1/2021,Sarawak,1401,0,1,1,1,0,1,376,10,97
15/1/2021,Selangor,9098,10,677,687,7,1001,1008,3704,63,40
15/1/2021,Terengganu,266,0,53,53,0,19,19,130,0,0
15/1/2021,W.P. Labuan,393,2,14,16,1,5,6,72,49,0
16/1/2021,Johor,3547,0,145,145,0,295,295,949,0,0
16/1/2021,Kedah,572,0,41,41,0,39,39,319,4,0
16/1/2021,Kelantan,387,0,27,27,15,24,39,224,19,23
16/1/2021,Melaka,268,8,9,17,1,13,14,124,8,8
16/1/2021,Negeri Sembilan,1301,0,75,75,0,269,269,450,0,0
16/1/2021,Pahang,722,0,32,32,0,5,5,295,0,0
16/1/2021,Perak,753,1,45,46,0,65,65,495,9,160
16/1/2021,Perlis,114,0,1,1,1,5,6,8,0,0
16/1/2021,Pulau Pinang,1205,0,67,67,0,71,71,336,0,0
16/1/2021,Sabah,5597,8,402,410,5,310,315,2195,73,0
16/1/2021,Sarawak,1559,2,0,2,1,0,1,465,3,63
16/1/2021,Selangor,9098,7,1279,1286,7,1086,1093,3897,63,40
16/1/2021,Terengganu,378,0,61,61,0,6,6,185,0,0
16/1/2021,W.P. Labuan,393,7,0,7,3,13,16,68,53,0
17/1/2021,Johor,4187,0,0,0,0,421,421,1063,0,0
17/1/2021,Kedah,872,0,64,64,0,115,115,270,1,0
17/1/2021,Kelantan,387,2,43,45,7,49,56,218,14,21
17/1/2021,Melaka,268,0,2,2,3,33,36,93,5,3
17/1/2021,Negeri Sembilan,1301,0,68,68,0,130,130,385,0,0
17/1/2021,Pahang,722,0,21,21,0,2,2,314,0,0
17/1/2021,Perak,767,0,49,49,0,34,34,508,14,171
17/1/2021,Perlis,114,0,10,10,0,0,0,20,0,0
17/1/2021,Pulau Pinang,1205,0,63,63,0,108,108,301,0,0
17/1/2021,Sabah,5747,5,345,350,14,358,372,2183,52,0
17/1/2021,Sarawak,1571,4,1,5,2,0,2,489,5,83
17/1/2021,Selangor,9098,15,1097,1112,12,1032,1044,3962,66,40
17/1/2021,Terengganu,378,0,44,44,0,17,17,212,0,0
17/1/2021,W.P. Labuan,393,3,2,5,2,7,9,78,43,0
18/1/2021,Johor,776,0,106,106,0,458,458,699,0,0
18/1/2021,Kedah,872,0,31,31,1,23,24,247,0,0
18/1/2021,Kelantan,467,3,53,56,5,37,42,234,12,24
18/1/2021,Melaka,188,1,46,47,3,12,15,95,5,5
18/1/2021,Negeri Sembilan,1301,0,53,53,0,65,65,373,0,0
18/1/2021,Pahang,722,0,43,43,0,2,2,355,0,0
18/1/2021,Perak,807,0,65,65,0,56,56,524,7,170
18/1/2021,Perlis,114,0,2,2,0,5,5,17,2,0
18/1/2021,Pulau Pinang,1205,0,74,74,0,77,77,300,0,0
18/1/2021,Sabah,5747,8,248,256,4,325,329,2112,59,0
18/1/2021,Sarawak,1617,4,0,4,3,0,3,532,11,99
18/1/2021,Selangor,9098,15,1185,1200,5,1097,1102,4050,76,40
18/1/2021,Terengganu,378,3,42,45,0,13,13,243,11,0
18/1/2021,W.P. Labuan,396,1,12,13,0,14,14,86,48,0
19/1/2021,Johor,777,0,91,91,0,304,304,707,0,0
19/1/2021,Kedah,872,0,54,54,0,37,37,246,0,0
19/1/2021,Kelantan,467,2,59,61,4,54,58,239,10,20
19/1/2021,Melaka,138,1,6,7,3,3,6,88,1,0
19/1/2021,Negeri Sembilan,1301,0,137,137,0,78,78,432,0,0
19/1/2021,Pahang,722,0,23,23,0,39,39,339,0,0
19/1/2021,Perak,807,0,55,55,1,242,243,337,3,174
19/1/2021,Perlis,114,0,5,5,0,0,0,24,2,0
19/1/2021,Pulau Pinang,1205,0,92,92,0,33,33,354,0,0
19/1/2021,Sabah,5737,18,424,442,4,336,340,2080,77,0
19/1/2021,Sarawak,1617,7,0,7,5,0,5,665,13,98
19/1/2021,Selangor,10940,9,717,726,10,692,702,4075,75,40
19/1/2021,Terengganu,378,0,30,30,0,11,11,262,11,0
19/1/2021,W.P. Labuan,396,18,4,22,1,10,11,84,65,0
20/1/2021,Johor,699,0,140,140,0,161,161,667,0,0
20/1/2021,Kedah,872,0,5,5,0,40,40,224,0,0
20/1/2021,Kelantan,467,4,58,62,5,42,47,255,9,20
20/1/2021,Melaka,138,0,3,3,0,12,12,78,3,0
20/1/2021,Negeri Sembilan,1301,0,73,73,0,67,67,437,0,0
20/1/2021,Pahang,722,0,50,50,0,45,45,344,0,0
20/1/2021,Perak,807,1,67,68,0,55,55,345,7,176
20/1/2021,Perlis,114,0,2,2,0,2,2,26,2,0
20/1/2021,Pulau Pinang,1215,0,81,81,0,62,62,363,0,0
20/1/2021,Sabah,5737,14,385,399,10,314,324,2118,71,0
20/1/2021,Sarawak,1713,4,0,4,5,0,5,728,13,93
20/1/2021,Selangor,10940,3,870,873,4,364,368,4582,74,40
20/1/2021,Terengganu,378,0,30,30,0,28,28,263,12,0
20/1/2021,W.P. Labuan,396,32,0,32,1,23,24,62,96,0
21/1/2021,Johor,699,0,49,49,0,78,78,640,0,0
21/1/2021,Kedah,872,0,21,21,0,101,101,156,1,0
21/1/2021,Kelantan,467,2,60,62,1,36,37,279,10,19
21/1/2021,Melaka,170,2,30,32,2,14,16,94,3,0
21/1/2021,Negeri Sembilan,1301,0,50,50,0,32,32,454,0,0
21/1/2021,Pahang,722,0,18,18,0,36,36,326,0,0
21/1/2021,Perak,807,0,59,59,0,39,39,366,8,168
21/1/2021,Perlis,114,0,6,6,0,0,0,32,6,0
21/1/2021,Pulau Pinang,1215,0,43,43,0,96,96,335,0,0
21/1/2021,Sabah,5687,14,356,370,13,388,401,2098,63,0
21/1/2021,Sarawak,1713,12,4,16,2,0,2,739,19,104
21/1/2021,Selangor,10940,7,822,829,9,885,894,4517,72,40
21/1/2021,Terengganu,428,3,31,34,0,64,64,230,9,0
21/1/2021,W.P. Labuan,396,3,0,3,1,12,13,51,99,0
22/1/2021,Johor,663,0,84,84,0,194,194,528,0,0
22/1/2021,Kedah,872,0,24,24,0,42,42,138,0,0
22/1/2021,Kelantan,587,2,41,43,5,37,42,283,7,20
22/1/2021,Melaka,170,0,6,6,2,11,13,89,1,1
22/1/2021,Negeri Sembilan,1137,0,50,50,0,77,77,426,0,0
22/1/2021,Pahang,722,0,40,40,0,79,79,287,0,0
22/1/2021,Perak,807,0,55,55,0,55,55,362,11,164
22/1/2021,Perlis,114,5,1,6,2,17,19,20,5,0
22/1/2021,Pulau Pinang,1215,0,79,79,0,80,80,331,0,0
22/1/2021,Sabah,5683,9,279,288,10,373,383,1977,63,0
22/1/2021,Sarawak,1713,7,0,7,4,0,4,727,23,95
22/1/2021,Selangor,10940,8,526,534,10,1300,1310,3748,66,40
22/1/2021,Terengganu,1128,6,66,72,1,59,60,237,15,0
22/1/2021,W.P. Labuan,396,11,12,23,3,9,12,81,88,0
23/1/2021,Johor,663,0,77,77,0,163,163,445,0,0
23/1/2021,Kedah,872,0,28,28,0,32,32,129,1,0
23/1/2021,Kelantan,587,3,57,60,3,54,57,286,7,13
23/1/2021,Melaka,170,0,5,5,0,13,13,101,0,0
23/1/2021,Negeri Sembilan,1087,0,30,30,0,109,109,344,0,0
23/1/2021,Pahang,722,0,44,44,0,56,56,273,0,0
23/1/2021,Perak,807,0,44,44,0,75,75,333,4,170
23/1/2021,Perlis,114,2,4,6,2,4,6,20,5,0
23/1/2021,Pulau Pinang,1215,0,76,76,0,66,66,299,0,0
23/1/2021,Sabah,5683,21,271,292,11,335,346,1899,77,0
23/1/2021,Sarawak,1891,6,1,7,11,0,11,648,15,104
23/1/2021,Selangor,10940,4,661,665,20,1062,1082,3348,50,40
23/1/2021,Terengganu,1128,3,92,95,0,58,58,270,17,0
23/1/2021,W.P. Labuan,396,0,5,5,0,19,19,80,81,0
24/1/2021,Johor,624,0,94,94,0,94,94,443,0,0
24/1/2021,Kedah,872,0,13,13,0,23,23,119,1,0
24/1/2021,Kelantan,587,1,36,37,2,57,59,265,6,10
24/1/2021,Melaka,120,0,11,11,0,51,51,61,1,1
24/1/2021,Negeri Sembilan,987,0,56,56,0,76,76,322,0,0
24/1/2021,Pahang,722,0,26,26,0,55,55,244,0,0
24/1/2021,Perak,807,0,59,59,0,96,96,298,1,166
24/1/2021,Perlis,114,2,3,5,0,2,2,22,6,0
24/1/2021,Pulau Pinang,1215,0,41,41,0,69,69,269,0,0
24/1/2021,Sabah,5683,17,347,364,8,334,342,1928,72,0
24/1/2021,Sarawak,1891,8,2,10,2,0,2,710,18,91
24/1/2021,Selangor,10940,13,862,875,29,1162,1191,3053,29,40
24/1/2021,Terengganu,1238,3,134,137,0,21,21,394,24,0
24/1/2021,W.P. Labuan,396,12,8,20,1,21,22,64,92,0
25/1/2021,Johor,496,0,97,97,0,103,103,373,0,0
25/1/2021,Kedah,872,0,44,44,0,22,22,128,0,0
25/1/2021,Kelantan,587,2,24,26,3,56,59,233,5,5
25/1/2021,Melaka,120,1,3,4,0,5,5,59,2,2
25/1/2021,Negeri Sembilan,987,0,35,35,0,52,52,303,0,0
25/1/2021,Pahang,722,0,11,11,0,35,35,220,0,0
25/1/2021,Perak,727,0,44,44,0,53,53,289,1,170
25/1/2021,Perlis,114,0,2,2,0,5,5,23,3,0
25/1/2021,Pulau Pinang,1215,0,34,34,0,80,80,225,0,0
25/1/2021,Sabah,5692,15,247,262,2,340,342,1825,86,0
25/1/2021,Sarawak,2047,0,39,39,0,0,0,769,20,97
25/1/2021,Selangor,9913,0,742,742,0,869,869,2935,21,40
25/1/2021,Terengganu,1238,9,143,152,3,34,37,496,29,0
25/1/2021,W.P. Labuan,396,0,11,11,0,1,1,105,68,0
26/1/2021,Johor,496,0,94,94,0,115,115,352,0,0
26/1/2021,Kedah,872,0,15,15,0,19,19,133,0,0
26/1/2021,Kelantan,587,2,22,24,2,39,41,216,5,4
26/1/2021,Melaka,120,1,13,14,0,28,28,44,3,3
26/1/2021,Negeri Sembilan,987,0,13,13,0,74,74,237,0,0
26/1/2021,Pahang,722,0,20,20,0,13,13,209,0,0
26/1/2021,Perak,727,0,21,21,0,38,38,271,1,162
26/1/2021,Perlis,114,2,0,2,1,1,2,24,4,0
26/1/2021,Pulau Pinang,1215,0,50,50,0,46,46,242,0,0
26/1/2021,Sabah,5692,22,334,356,15,294,309,1882,92,0
26/1/2021,Sarawak,2047,11,6,17,3,0,3,850,24,94
26/1/2021,Selangor,9913,0,500,500,0,467,467,2971,18,40
26/1/2021,Terengganu,1238,2,126,128,0,23,23,538,38,0
26/1/2021,W.P. Labuan,396,34,0,34,0,6,6,99,104,0
27/1/2021,Johor,496,0,106,106,0,54,54,404,0,0
27/1/2021,Kedah,872,0,17,17,0,21,21,135,0,0
27/1/2021,Kelantan,587,0,11,11,0,55,55,172,5,3
27/1/2021,Melaka,120,0,15,15,2,8,10,51,1,1
27/1/2021,Negeri Sembilan,987,0,3,3,0,43,43,196,0,0
27/1/2021,Pahang,722,0,8,8,0,22,22,201,0,0
27/1/2021,Perak,730,0,44,44,0,40,40,274,2,160
27/1/2021,Perlis,114,1,3,4,1,1,2,28,3,0
27/1/2021,Pulau Pinang,1215,0,45,45,0,38,38,249,0,0
27/1/2021,Sabah,5692,6,209,215,10,230,240,1846,67,0
27/1/2021,Sarawak,2224,7,11,18,2,2,4,878,27,101
27/1/2021,Selangor,7913,0,614,614,1,314,315,3271,17,40
27/1/2021,Terengganu,1238,1,76,77,5,76,81,538,34,0
27/1/2021,W.P. Labuan,396,32,0,32,1,17,18,86,136,0
28/1/2021,Johor,496,0,105,105,0,61,61,448,0,0
28/1/2021,Kedah,872,0,11,11,0,37,37,111,0,0
28/1/2021,Kelantan,587,2,15,17,0,40,40,147,7,1
28/1/2021,Melaka,120,0,13,13,0,12,12,52,1,1
28/1/2021,Negeri Sembilan,977,0,13,13,0,48,48,160,0,0
28/1/2021,Pahang,722,0,20,20,0,82,82,146,0,0
28/1/2021,Perak,730,0,45,45,0,28,28,290,3,167
28/1/2021,Perlis,114,0,1,1,1,3,4,26,2,0
28/1/2021,Pulau Pinang,1215,0,40,40,0,54,54,237,0,0
28/1/2021,Sabah,5289,7,273,280,6,226,232,1855,71,0
28/1/2021,Sarawak,2224,7,29,36,5,11,16,933,28,101
28/1/2021,Selangor,7913,0,770,770,11,1101,1112,2940,6,40
28/1/2021,Terengganu,1238,4,22,26,11,30,41,519,33,0
28/1/2021,W.P. Labuan,396,7,37,44,4,25,29,101,107,0
29/1/2021,Johor,496,0,103,103,0,116,116,447,0,0
29/1/2021,Kedah,872,0,15,15,0,21,21,107,0,0
29/1/2021,Kelantan,587,0,11,11,4,27,31,131,3,1
29/1/2021,Melaka,120,0,18,18,1,15,16,55,0,0
29/1/2021,Negeri Sembilan,977,0,5,5,0,44,44,120,0,0
29/1/2021,Pahang,722,0,29,29,0,27,27,138,0,0
29/1/2021,Perak,730,0,43,43,0,38,38,289,3,171
29/1/2021,Perlis,114,0,1,1,0,9,9,18,2,0
29/1/2021,Pulau Pinang,1215,0,48,48,0,37,37,249,0,0
29/1/2021,Sabah,5432,10,194,204,18,350,368,1675,57,0
29/1/2021,Sarawak,2224,3,8,11,10,1,11,922,22,97
29/1/2021,Selangor,7613,0,777,777,2,498,500,3223,4,39
29/1/2021,Terengganu,1238,2,106,108,4,55,59,569,31,0
29/1/2021,W.P. Labuan,396,5,4,9,1,4,5,99,106,0
30/1/2021,Johor,496,0,79,79,0,68,68,446,0,0
30/1/2021,Kedah,872,0,20,20,0,22,22,110,0,0
30/1/2021,Kelantan,587,1,21,22,0,42,42,110,4,1
30/1/2021,Melaka,120,0,6,6,0,12,12,49,0,0
30/1/2021,Negeri Sembilan,967,0,0,0,0,28,28,35,0,0
30/1/2021,Pahang,722,0,17,17,0,47,47,110,0,0
30/1/2021,Perak,730,0,51,51,0,46,46,293,4,156
30/1/2021,Perlis,114,0,0,0,0,4,4,15,2,0
30/1/2021,Pulau Pinang,1215,0,53,53,0,53,53,245,0,0
30/1/2021,Sabah,5432,13,261,274,9,324,333,1595,61,0
30/1/2021,Sarawak,2224,6,63,69,4,45,49,991,17,95
30/1/2021,Selangor,7613,0,648,648,4,712,716,3159,0,40
30/1/2021,Terengganu,1238,0,93,93,5,92,97,570,26,0
30/1/2021,W.P. Labuan,396,6,3,9,4,17,21,87,94,0
31/1/2021,Johor,496,0,98,98,0,113,113,428,0,0
31/1/2021,Kedah,872,0,14,14,0,17,17,121,0,0
31/1/2021,Kelantan,587,1,20,21,0,26,26,104,5,0
31/1/2021,Melaka,90,0,5,5,0,16,16,38,0,0
31/1/2021,Negeri Sembilan,967,0,3,3,0,21,21,48,0,0
31/1/2021,Pahang,722,0,44,44,0,18,18,132,0,0
31/1/2021,Perak,730,0,22,22,0,40,40,275,2,164
31/1/2021,Perlis,114,1,0,1,1,2,3,12,0,0
31/1/2021,Pulau Pinang,1215,0,64,64,0,56,56,249,0,0
31/1/2021,Sabah,5351,9,219,228,10,349,359,1443,61,0
31/1/2021,Sarawak,2178,14,25,39,6,23,29,935,33,85
31/1/2021,Selangor,7313,1,1263,1264,1,814,815,3608,0,40
31/1/2021,Terengganu,1238,10,63,73,8,97,105,539,22,0
31/1/2021,W.P. Labuan,396,7,21,28,12,26,38,86,81,0
1/2/2021,Johor,496,0,89,89,0,96,96,421,0,0
1/2/2021,Kedah,872,0,45,45,0,35,35,141,0,0
1/2/2021,Kelantan,587,4,10,14,2,26,28,88,7,0
1/2/2021,Melaka,90,1,38,39,0,8,8,68,1,0
1/2/2021,Negeri Sembilan,967,0,0,0,0,20,20,15,0,0
1/2/2021,Pahang,722,0,20,20,0,15,15,137,0,0
1/2/2021,Perak,730,0,51,51,0,33,33,292,2,160
1/2/2021,Perlis,114,1,0,1,0,4,4,8,0,0
1/2/2021,Pulau Pinang,1215,0,23,23,0,55,55,239,0,0
1/2/2021,Sabah,5033,3,197,200,8,270,278,1342,54,0
1/2/2021,Sarawak,2338,4,8,12,0,13,13,1010,29,89
1/2/2021,Selangor,7313,1,1876,1877,1,201,202,5283,0,40
1/2/2021,Terengganu,1238,0,33,33,5,64,69,508,17,0
1/2/2021,W.P. Labuan,396,0,2,2,2,2,4,107,66,0
2/2/2021,Johor,496,0,91,91,0,166,166,346,0,0
2/2/2021,Kedah,872,0,6,6,0,18,18,126,0,0
2/2/2021,Kelantan,587,1,24,25,1,10,11,102,7,0
2/2/2021,Melaka,113,0,27,27,1,3,4,92,0,0
2/2/2021,Negeri Sembilan,937,0,0,0,0,15,15,0,0,0
2/2/2021,Pahang,722,0,27,27,0,28,28,147,0,0
2/2/2021,Perak,730,0,130,130,0,50,50,368,3,171
2/2/2021,Perlis,114,0,1,1,0,0,0,9,0,0
2/2/2021,Pulau Pinang,1215,0,63,63,0,34,34,280,0,0
2/2/2021,Sabah,5033,12,217,229,6,264,270,1307,60,0
2/2/2021,Sarawak,2368,6,21,27,2,9,11,948,34,102
2/2/2021,Selangor,9317,0,867,867,0,574,574,5576,0,40
2/2/2021,Terengganu,1238,2,26,28,2,17,19,517,17,0
2/2/2021,W.P. Labuan,396,0,2,2,0,7,7,102,59,0
3/2/2021,Johor,496,0,81,81,0,55,55,371,0,0
3/2/2021,Kedah,872,0,43,43,0,17,17,165,0,0
3/2/2021,Kelantan,587,1,17,18,3,15,18,104,5,0
3/2/2021,Melaka,113,0,6,6,0,9,9,89,0,0
3/2/2021,Negeri Sembilan,437,0,0,0,0,0,0,0,0,0
3/2/2021,Pahang,722,0,60,60,0,9,9,217,0,0
3/2/2021,Perak,730,0,29,29,0,27,27,369,1,176
3/2/2021,Perlis,114,0,0,0,0,3,3,5,0,0
3/2/2021,Pulau Pinang,1215,0,50,50,0,29,29,298,0,0
3/2/2021,Sabah,5033,2,160,162,11,214,225,1272,42,0
3/2/2021,Sarawak,2368,3,28,31,6,19,25,990,29,84
3/2/2021,Selangor,9367,0,675,675,0,1040,1040,5377,0,40
3/2/2021,Terengganu,1238,0,38,38,1,88,89,467,16,0
3/2/2021,W.P. Labuan,396,0,1,1,2,8,10,101,47,0
4/2/2021,Johor,655,0,107,107,0,47,47,590,0,0
4/2/2021,Kedah,872,0,42,42,0,10,10,202,0,0
4/2/2021,Kelantan,587,1,9,10,0,14,14,99,6,0
4/2/2021,Melaka,113,0,5,5,0,24,24,70,0,0
4/2/2021,Negeri Sembilan,437,0,0,0,0,0,0,0,0,0
4/2/2021,Pahang,722,0,30,30,0,18,18,224,0,0
4/2/2021,Perak,730,0,102,102,0,41,41,428,3,152
4/2/2021,Perlis,130,0,16,16,0,2,2,19,0,0
4/2/2021,Pulau Pinang,1215,0,86,86,0,59,59,324,0,0
4/2/2021,Sabah,5033,3,162,165,10,242,252,1171,27,0
4/2/2021,Sarawak,2368,4,7,11,4,51,55,969,30,81
4/2/2021,Selangor,9367,0,1142,1142,0,1276,1276,5242,0,40
4/2/2021,Terengganu,1238,3,44,47,5,99,104,412,13,0
4/2/2021,W.P. Labuan,402,5,1,6,6,25,31,78,46,0
5/2/2021,Johor,655,0,84,84,0,131,131,542,0,0
5/2/2021,Kedah,872,0,43,43,0,25,25,222,0,0
5/2/2021,Kelantan,587,3,23,26,2,8,10,115,5,0
5/2/2021,Melaka,113,0,7,7,0,10,10,67,0,0
5/2/2021,Negeri Sembilan,437,0,0,0,0,0,0,0,0,0
5/2/2021,Pahang,722,0,71,71,0,9,9,279,0,0
5/2/2021,Perak,730,0,58,58,0,45,45,441,0,154
5/2/2021,Perlis,130,0,0,0,0,4,4,15,0,0
5/2/2021,Pulau Pinang,1215,0,100,100,0,55,55,370,0,0
5/2/2021,Sabah,5033,10,174,184,10,232,242,1115,29,0
5/2/2021,Sarawak,2368,2,9,11,11,19,30,971,13,85
5/2/2021,Selangor,9367,0,697,697,0,1359,1359,4580,0,40
5/2/2021,Terengganu,1238,3,107,110,0,66,66,453,16,0
5/2/2021,W.P. Labuan,402,0,5,5,13,22,35,62,32,0
6/2/2021,Johor,662,0,146,146,0,76,76,609,0,0
6/2/2021,Kedah,672,0,36,36,0,24,24,240,0,0
6/2/2021,Kelantan,587,1,14,15,1,6,7,123,5,0
6/2/2021,Melaka,113,0,31,31,0,1,1,93,0,0
6/2/2021,Negeri Sembilan,437,0,0,0,0,0,0,0,0,0
6/2/2021,Pahang,722,0,37,37,0,33,33,283,0,0
6/2/2021,Perak,730,1,12,13,0,27,27,427,2,124
6/2/2021,Perlis,130,0,2,2,0,1,1,16,0,0
6/2/2021,Pulau Pinang,1215,0,89,89,0,42,42,420,0,0
6/2/2021,Sabah,5033,16,120,136,1,191,192,1024,40,0
6/2/2021,Sarawak,2368,12,23,35,3,5,8,1024,20,52
6/2/2021,Selangor,9367,0,853,853,0,851,851,4580,0,40
6/2/2021,Terengganu,1238,0,63,63,6,112,118,404,10,0
6/2/2021,W.P. Labuan,402,0,7,7,4,11,15,60,24,0
7/2/2021,Johor,668,0,77,77,0,111,111,574,0,0
7/2/2021,Kedah,672,0,15,15,0,55,55,198,0,0
7/2/2021,Kelantan,587,2,12,14,0,29,29,106,7,0
7/2/2021,Melaka,113,2,7,9,0,27,27,73,2,2
7/2/2021,Negeri Sembilan,437,0,0,0,0,0,0,0,0,0
7/2/2021,Pahang,722,0,34,34,0,35,35,282,0,0
7/2/2021,Perak,730,0,29,29,0,43,43,411,2,129
7/2/2021,Perlis,130,0,0,0,0,0,0,16,0,0
7/2/2021,Pulau Pinang,1215,0,88,88,0,56,56,440,0,0
7/2/2021,Sabah,5033,11,143,154,6,184,190,1009,47,0
7/2/2021,Sarawak,2426,11,60,71,5,13,18,1117,31,52
7/2/2021,Selangor,9367,2,1420,1422,0,804,804,5196,2,40
7/2/2021,Terengganu,1238,0,19,19,1,89,90,334,9,0
7/2/2021,W.P. Labuan,402,0,0,0,5,10,15,48,19,0
8/2/2021,Johor,644,0,35,35,0,99,99,510,0,0
8/2/2021,Kedah,672,0,33,33,0,32,32,203,0,0
8/2/2021,Kelantan,587,4,11,15,1,17,18,100,10,0
8/2/2021,Melaka,113,0,23,23,0,16,16,80,2,2
8/2/2021,Pahang,722,0,18,18,0,26,26,272,0,0
8/2/2021,Perak,730,0,33,33,0,48,48,396,2,160
8/2/2021,Perlis,130,0,1,1,0,0,0,17,0,0
8/2/2021,Pulau Pinang,1215,0,147,147,0,94,94,509,0,0
8/2/2021,Sabah,5033,5,108,113,4,173,177,923,46,0
8/2/2021,Sarawak,2426,5,52,57,8,15,23,1123,26,52
8/2/2021,Selangor,9367,2,1398,1400,0,764,764,5208,4,40
8/2/2021,Terengganu,1238,0,21,21,1,20,21,335,8,0
8/2/2021,W.P. Labuan,402,0,0,0,2,13,15,34,20,0
9/2/2021,Johor,644,0,66,66,0,131,131,445,0,0
9/2/2021,Kedah,672,0,24,24,0,26,26,204,0,0
9/2/2021,Kelantan,587,2,10,12,2,13,15,97,10,0
9/2/2021,Melaka,113,0,14,14,1,19,20,75,1,1
9/2/2021,Pahang,722,0,21,21,0,81,81,214,0,0
9/2/2021,Perak,730,0,4,4,0,99,99,301,3,172
9/2/2021,Perlis,130,0,0,0,0,0,0,17,0,0
9/2/2021,Pulau Pinang,1215,0,87,87,0,67,67,530,0,0
9/2/2021,Sabah,5033,14,128,142,4,187,191,862,53,0
9/2/2021,Sarawak,2526,8,30,38,4,21,25,1141,31,51
9/2/2021,Selangor,9367,10,920,930,1,399,400,5698,13,40
9/2/2021,Terengganu,1238,1,15,16,0,24,24,326,9,0
9/2/2021,W.P. Labuan,402,3,0,3,1,11,12,24,22,0
10/2/2021,Johor,644,0,50,50,0,60,60,434,0,0
10/2/2021,Kedah,672,0,26,26,0,21,21,211,0,0
10/2/2021,Kelantan,587,4,22,26,2,23,25,96,12,0
10/2/2021,Melaka,113,0,7,7,1,14,15,68,0,0
10/2/2021,Pahang,722,0,11,11,0,41,41,184,0,0
10/2/2021,Perak,730,0,17,17,0,41,41,277,5,161
10/2/2021,Perlis,130,0,0,0,0,8,8,14,0,0
10/2/2021,Pulau Pinang,1215,0,54,54,0,102,102,495,0,0
10/2/2021,Sabah,5033,7,144,151,8,126,134,907,54,0
10/2/2021,Sarawak,2666,14,14,28,7,38,45,1140,34,55
10/2/2021,Selangor,9367,8,885,893,5,1363,1368,5219,15,40
10/2/2021,Terengganu,1238,1,10,11,2,19,21,317,8,0
10/2/2021,W.P. Labuan,402,0,9,9,0,8,8,25,19,0
11/2/2021,Johor,944,0,61,61,0,45,45,478,0,0
11/2/2021,Kedah,672,0,28,28,0,27,27,212,0,0
11/2/2021,Kelantan,587,4,21,25,4,14,18,103,12,0
11/2/2021,Melaka,234,0,34,34,0,8,8,94,0,0
11/2/2021,Negeri Sembilan,20,0,13,13,0,0,0,13,0,0
11/2/2021,Pahang,722,0,16,16,0,41,41,157,0,0
11/2/2021,Perak,730,0,40,40,0,18,18,299,3,164
11/2/2021,Perlis,130,0,3,3,0,0,0,17,0,0
11/2/2021,Pulau Pinang,1215,0,41,41,0,107,107,434,0,0
11/2/2021,Sabah,5033,4,103,107,7,139,146,872,51,0
11/2/2021,Sarawak,2736,13,18,31,5,56,61,1095,38,55
11/2/2021,Selangor,9367,12,1354,1366,0,1485,1485,5088,26,40
11/2/2021,Terengganu,1238,4,34,38,0,39,39,312,12,0
11/2/2021,W.P. Labuan,402,1,2,3,0,1,1,26,20,0
12/2/2021,Johor,944,0,69,69,0,104,104,415,0,0
12/2/2021,Kedah,672,0,46,46,0,40,40,217,0,0
12/2/2021,Kelantan,587,9,16,25,6,12,18,107,15,2
12/2/2021,Melaka,234,0,46,46,0,11,11,129,0,0
12/2/2021,Negeri Sembilan,10,0,0,0,0,13,13,0,0,0
12/2/2021,Pahang,722,0,6,6,0,35,35,131,0,0
12/2/2021,Perak,730,0,31,31,0,43,43,307,3,170
12/2/2021,Perlis,130,0,1,1,0,0,0,17,0,0
12/2/2021,Pulau Pinang,1215,0,61,61,0,128,128,368,0,0
12/2/2021,Sabah,5033,6,108,114,12,223,235,767,45,0
12/2/2021,Sarawak,2736,13,16,29,8,26,34,1063,38,55
12/2/2021,Selangor,9339,3,1126,1129,4,1019,1023,5196,24,40
12/2/2021,Terengganu,1238,0,12,12,3,35,38,289,8,0
12/2/2021,W.P. Labuan,402,0,1,1,0,6,6,26,11,0
13/2/2021,Johor,944,0,55,55,0,87,87,383,0,0
13/2/2021,Kedah,672,0,148,148,0,36,36,338,0,0
13/2/2021,Kelantan,587,3,42,45,5,23,28,126,13,2
13/2/2021,Melaka,234,0,18,18,0,31,31,116,0,0
13/2/2021,Negeri Sembilan,10,0,0,0,0,0,0,0,0,0
13/2/2021,Pahang,722,0,9,9,0,38,38,102,0,0
13/2/2021,Perak,730,0,45,45,0,96,96,258,1,167
13/2/2021,Perlis,130,0,2,2,0,5,5,15,0,0
13/2/2021,Pulau Pinang,1215,0,80,80,0,92,92,360,0,0
13/2/2021,Sabah,5033,5,73,78,8,203,211,694,41,0
13/2/2021,Sarawak,2736,6,21,27,5,7,12,1079,37,47
13/2/2021,Selangor,9339,10,1176,1186,7,1159,1166,5214,30,40
13/2/2021,Terengganu,1509,0,41,41,0,47,47,283,8,0
13/2/2021,W.P. Labuan,402,0,0,0,2,10,12,19,14,0
14/2/2021,Johor,944,0,56,56,0,49,49,390,0,0
14/2/2021,Kedah,672,0,42,42,0,53,53,326,0,0
14/2/2021,Kelantan,587,4,28,32,8,15,23,139,9,2
14/2/2021,Melaka,234,0,19,19,0,14,14,121,0,0
14/2/2021,Negeri Sembilan,10,0,0,0,0,0,0,0,0,0
14/2/2021,Pahang,722,0,3,3,0,42,42,68,0,0
14/2/2021,Perak,730,0,52,52,0,49,49,261,1,162
14/2/2021,Perlis,130,0,0,0,0,2,2,13,0,0
14/2/2021,Pulau Pinang,1215,0,81,81,0,80,80,356,0,0
14/2/2021,Sabah,5033,5,75,80,7,163,170,634,42,0
14/2/2021,Sarawak,2736,10,10,20,2,26,28,1049,55,44
14/2/2021,Selangor,9339,2,490,492,5,716,721,4994,23,40
14/2/2021,Terengganu,1509,0,37,37,0,77,77,223,8,0
14/2/2021,W.P. Labuan,402,0,0,0,0,5,5,14,14,0
15/2/2021,Johor,944,0,82,82,0,63,63,408,0,0
15/2/2021,Kedah,672,0,29,29,0,19,19,336,0,0
15/2/2021,Kelantan,587,4,54,58,1,13,14,180,12,2
15/2/2021,Melaka,234,0,2,2,0,17,17,106,0,0
15/2/2021,Negeri Sembilan,10,0,0,0,0,0,0,0,0,0
15/2/2021,Pahang,722,0,9,9,0,16,16,61,0,0
15/2/2021,Perak,730,0,7,7,0,26,26,241,1,165
15/2/2021,Perlis,130,0,0,0,0,0,0,13,0,0
15/2/2021,Pulau Pinang,1215,0,47,47,0,70,70,343,0,0
15/2/2021,Sabah,5033,6,84,90,6,116,122,576,34,0
15/2/2021,Sarawak,2736,2,30,32,8,58,66,1018,32,39
15/2/2021,Selangor,9339,5,688,693,9,955,964,4862,18,40
15/2/2021,Terengganu,1509,0,31,31,5,42,47,212,3,0
15/2/2021,W.P. Labuan,402,0,0,0,0,0,0,14,14,0
16/2/2021,Johor,944,0,53,53,0,98,98,362,0,0
16/2/2021,Kedah,672,0,24,24,0,19,19,343,0,0
16/2/2021,Kelantan,587,1,24,25,9,19,28,185,4,2
16/2/2021,Melaka,234,0,3,3,0,5,5,104,0,0
16/2/2021,Negeri Sembilan,10,0,8,8,0,0,0,8,0,0
16/2/2021,Pahang,722,0,7,7,0,14,14,87,0,0
16/2/2021,Perak,737,0,72,72,0,20,20,293,1,188
16/2/2021,Perlis,130,0,0,0,0,0,0,8,0,0
16/2/2021,Pulau Pinang,1215,0,54,54,0,57,57,340,0,0
16/2/2021,Sabah,4935,4,58,62,9,99,108,526,29,0
16/2/2021,Sarawak,2736,10,16,26,6,22,28,967,32,46
16/2/2021,Selangor,9339,3,928,931,0,676,676,5114,21,40
16/2/2021,Terengganu,1509,1,34,35,1,13,14,233,3,0
16/2/2021,W.P. Labuan,402,0,0,0,0,1,1,13,13,0
17/2/2021,Johor,944,0,84,84,0,64,64,384,0,0
17/2/2021,Kedah,672,0,47,47,0,11,11,378,0,0
17/2/2021,Kelantan,587,5,8,13,4,20,24,173,6,2
17/2/2021,Melaka,234,0,2,2,0,7,7,101,0,0
17/2/2021,Negeri Sembilan,10,0,0,0,0,0,0,8,0,0
17/2/2021,Pahang,722,0,4,4,0,5,5,53,0,0
17/2/2021,Perak,737,0,49,49,0,15,15,325,1,168
17/2/2021,Perlis,130,0,0,0,0,0,0,8,0,0
17/2/2021,Pulau Pinang,1215,0,36,36,0,30,30,353,0,0
17/2/2021,Sabah,4935,2,104,106,0,61,61,565,20,0
17/2/2021,Sarawak,3240,14,20,34,1,21,22,1144,44,56
17/2/2021,Selangor,9339,2,1220,1222,3,409,412,5927,18,40
17/2/2021,Terengganu,1509,0,22,22,0,49,49,206,3,0
17/2/2021,W.P. Labuan,402,0,0,0,0,4,4,10,14,0
18/2/2021,Johor,944,0,79,79,0,75,75,389,0,0
18/2/2021,Kedah,672,1,11,12,0,30,30,360,1,0
18/2/2021,Kelantan,587,2,13,15,2,19,21,167,7,1
18/2/2021,Melaka,234,0,13,13,0,41,41,67,0,0
18/2/2021,Negeri Sembilan,10,0,0,0,0,0,0,8,0,0
18/2/2021,Pahang,722,0,9,9,0,15,15,47,0,0
18/2/2021,Perak,727,0,30,30,0,8,8,347,1,158
18/2/2021,Perlis,130,0,0,0,0,3,3,5,0,0
18/2/2021,Pulau Pinang,1215,0,68,68,0,55,55,366,0,0
18/2/2021,Sabah,4935,1,80,81,1,105,106,552,19,0
18/2/2021,Sarawak,3240,12,57,69,5,25,30,1125,51,55
18/2/2021,Selangor,7429,7,807,814,4,1037,1041,5699,19,40
18/2/2021,Terengganu,1509,0,10,10,2,20,22,196,1,0
18/2/2021,W.P. Labuan,402,1,4,5,3,5,8,9,12,0
19/2/2021,Johor,1394,0,88,88,0,58,58,418,0,0
19/2/2021,Kedah,672,0,15,15,0,187,187,188,0,0
19/2/2021,Kelantan,587,0,20,20,2,19,21,173,0,0
19/2/2021,Melaka,234,0,10,10,0,31,31,48,0,0
19/2/2021,Negeri Sembilan,10,0,0,0,0,0,0,8,0,0
19/2/2021,Pahang,722,0,18,18,0,5,5,60,0,0
19/2/2021,Perak,727,0,78,78,0,30,30,392,3,153
19/2/2021,Perlis,130,0,1,1,0,0,0,6,0,0
19/2/2021,Pulau Pinang,1215,0,58,58,0,97,97,335,0,0
19/2/2021,Sabah,4935,1,69,70,2,84,86,539,18,0
19/2/2021,Sarawak,3240,14,40,54,6,17,23,1277,57,51
19/2/2021,Selangor,7429,9,789,798,6,1334,1340,5156,20,40
19/2/2021,Terengganu,1509,0,26,26,0,9,9,213,1,0
19/2/2021,W.P. Labuan,402,3,0,3,2,3,5,5,13,0
20/2/2021,Johor,1394,0,44,44,0,65,65,406,0,0
20/2/2021,Kedah,672,0,11,11,0,32,32,167,0,0
20/2/2021,Kelantan,587,2,5,7,2,19,21,150,9,1
20/2/2021,Melaka,234,0,6,6,0,16,16,37,0,0
20/2/2021,Negeri Sembilan,10,0,1,1,0,0,0,9,0,0
20/2/2021,Pahang,722,0,18,18,0,9,9,60,0,0
20/2/2021,Perak,727,0,39,39,0,24,24,406,2,156
20/2/2021,Perlis,130,0,0,0,0,0,0,6,0,0
20/2/2021,Pulau Pinang,1215,0,93,93,0,82,82,335,0,0
20/2/2021,Sabah,4935,5,73,78,2,93,95,514,22,0
20/2/2021,Sarawak,3240,5,41,46,5,18,23,1365,69,41
20/2/2021,Selangor,7429,5,524,529,3,1083,1086,4597,22,40
20/2/2021,Terengganu,1509,0,15,15,0,16,16,212,1,0
20/2/2021,W.P. Labuan,402,2,1,3,1,0,1,6,14,0
21/2/2021,Johor,1394,0,59,59,0,83,83,370,0,0
21/2/2021,Kedah,672,0,34,34,0,19,19,182,0,0
21/2/2021,Kelantan,587,1,30,31,6,18,24,162,4,1
21/2/2021,Melaka,234,0,7,7,0,17,17,27,0,0
21/2/2021,Negeri Sembilan,10,0,0,0,0,0,0,9,0,0
21/2/2021,Pahang,722,0,14,14,0,5,5,75,0,0
21/2/2021,Perak,727,0,59,59,0,75,75,391,1,169
21/2/2021,Perlis,130,0,0,0,0,0,0,6,0,0
21/2/2021,Pulau Pinang,1215,0,45,45,0,49,49,337,0,0
21/2/2021,Sabah,4935,2,91,93,5,79,84,541,20,0
21/2/2021,Sarawak,3240,2,27,29,9,16,25,1340,47,49
21/2/2021,Selangor,7429,7,1293,1300,3,1063,1066,4829,24,40
21/2/2021,Terengganu,1509,0,15,15,0,22,22,205,1,0
21/2/2021,W.P. Labuan,402,3,0,3,1,0,1,6,16,0
22/2/2021,Johor,1394,0,105,105,0,75,75,398,0,0
22/2/2021,Kedah,672,0,16,16,0,40,40,163,0,0
22/2/2021,Kelantan,587,1,10,11,4,16,20,156,1,1
22/2/2021,Melaka,234,0,18,18,0,5,5,40,0,0
22/2/2021,Negeri Sembilan,10,0,0,0,0,0,0,9,0,0
22/2/2021,Pahang,722,0,4,4,0,9,9,69,0,0
22/2/2021,Perak,727,0,78,78,0,62,62,407,1,168
22/2/2021,Perlis,130,0,0,0,0,0,0,10,0,0
22/2/2021,Pulau Pinang,1215,0,53,53,0,24,24,357,0,0
22/2/2021,Sabah,4913,0,45,45,4,86,90,477,19,0
22/2/2021,Sarawak,3240,15,30,45,3,37,40,1405,54,50
22/2/2021,Selangor,7429,6,1049,1055,6,262,268,5618,22,40
22/2/2021,Terengganu,1509,0,5,5,1,36,37,174,0,0
22/2/2021,W.P. Labuan,402,0,3,3,0,0,0,9,15,0
23/2/2021,Johor,1394,0,63,63,0,51,51,406,1,0
23/2/2021,Kedah,672,0,3,3,0,45,45,121,0,0
23/2/2021,Kelantan,587,2,8,10,1,13,14,151,2,1
23/2/2021,Melaka,234,0,4,4,0,2,2,42,0,0
23/2/2021,Negeri Sembilan,10,0,0,0,0,8,8,1,0,0
23/2/2021,Pahang,722,0,4,4,0,9,9,64,0,0
23/2/2021,Perak,727,0,119,119,0,43,43,482,1,167
23/2/2021,Perlis,130,0,0,0,0,3,3,7,0,0
23/2/2021,Pulau Pinang,1215,0,81,81,0,56,56,408,0,0
23/2/2021,Sabah,4913,2,80,82,1,92,93,464,12,0
23/2/2021,Sarawak,3311,9,3,12,1,35,36,1389,63,43
23/2/2021,Selangor,7429,4,871,875,7,1089,1096,5400,23,40
23/2/2021,Terengganu,1509,0,0,0,0,30,30,144,0,0
23/2/2021,W.P. Labuan,402,0,3,3,0,0,0,12,11,0
24/2/2021,Johor,1222,0,62,62,1,37,38,428,2,0
24/2/2021,Kedah,672,0,6,6,0,14,14,119,0,0
24/2/2021,Kelantan,587,2,16,18,2,69,71,98,2,2
24/2/2021,Melaka,234,0,2,2,0,3,3,41,0,0
24/2/2021,Negeri Sembilan,10,0,6,6,0,0,0,7,0,0
24/2/2021,Pahang,722,0,3,3,0,3,3,63,0,0
24/2/2021,Perak,727,0,59,59,0,34,34,506,0,162
24/2/2021,Perlis,130,0,0,0,0,1,1,6,0,0
24/2/2021,Pulau Pinang,1215,0,76,76,0,62,62,421,0,0
24/2/2021,Sabah,4913,3,91,94,5,53,58,499,14,0
24/2/2021,Sarawak,3311,8,0,8,4,19,23,1377,70,48
24/2/2021,Selangor,7429,6,1022,1028,4,529,533,5893,25,40
24/2/2021,Terengganu,1509,0,19,19,0,37,37,126,0,0
24/2/2021,W.P. Labuan,402,6,0,6,2,1,3,13,11,0
25/2/2021,Johor,1222,0,79,79,0,44,44,464,0,0
25/2/2021,Kedah,672,0,12,12,0,16,16,115,0,0
25/2/2021,Kelantan,587,1,21,22,0,6,6,113,3,2
25/2/2021,Melaka,234,0,17,17,0,4,4,54,0,0
25/2/2021,Negeri Sembilan,10,0,0,0,0,0,0,7,0,0
25/2/2021,Pahang,722,0,9,9,0,9,9,63,0,0
25/2/2021,Perak,727,0,33,33,0,49,49,490,0,147
25/2/2021,Perlis,130,0,1,1,0,1,1,6,0,0
25/2/2021,Pulau Pinang,1215,0,80,80,0,85,85,419,0,0
25/2/2021,Sabah,4913,4,76,80,2,78,80,502,10,0
25/2/2021,Sarawak,3637,6,35,41,6,31,37,1405,245,44
25/2/2021,Selangor,7429,3,1030,1033,4,1211,1215,5714,22,40
25/2/2021,Terengganu,1509,0,7,7,0,27,27,106,0,0
25/2/2021,W.P. Labuan,402,0,0,0,0,0,0,13,11,0
26/2/2021,Johor,1222,0,76,76,0,91,91,451,0,0
26/2/2021,Kedah,672,0,4,4,0,19,19,100,0,0
26/2/2021,Kelantan,587,2,18,20,2,17,19,104,3,2
26/2/2021,Melaka,126,0,2,2,0,11,11,45,0,0
26/2/2021,Negeri Sembilan,10,0,0,0,0,1,1,6,0,0
26/2/2021,Pahang,722,0,2,2,0,17,17,49,0,0
26/2/2021,Perak,727,0,31,31,0,64,64,455,0,163
26/2/2021,Perlis,130,0,3,3,0,0,0,9,0,0
26/2/2021,Pulau Pinang,1215,0,68,68,0,81,81,409,0,0
26/2/2021,Sabah,4913,3,58,61,0,43,43,517,12,0
26/2/2021,Sarawak,3637,5,40,45,9,27,36,1575,240,48
26/2/2021,Selangor,7429,2,784,786,3,758,761,5742,18,40
26/2/2021,Terengganu,1509,0,1,1,0,7,7,100,0,0
26/2/2021,W.P. Labuan,402,3,3,6,2,4,6,16,11,0
27/2/2021,Johor,1222,0,61,61,0,58,58,445,0,0
27/2/2021,Kedah,672,0,4,4,0,16,16,88,0,0
27/2/2021,Kelantan,587,1,25,26,3,10,13,119,1,1
27/2/2021,Melaka,126,0,7,7,0,7,7,45,0,0
27/2/2021,Negeri Sembilan,10,0,0,0,0,0,0,6,0,0
27/2/2021,Pahang,722,0,6,6,0,18,18,32,0,0
27/2/2021,Perak,927,0,125,125,0,112,112,655,0,152
27/2/2021,Perlis,130,0,0,0,0,0,0,9,0,0
27/2/2021,Pulau Pinang,1215,0,60,60,0,87,87,397,0,0
27/2/2021,Sabah,4913,4,114,118,3,98,101,537,15,0
27/2/2021,Sarawak,3637,11,20,31,12,50,62,1527,209,47
27/2/2021,Selangor,7429,22,970,992,4,712,716,6000,36,40
27/2/2021,Terengganu,1509,0,1,1,0,15,15,86,0,0
27/2/2021,W.P. Labuan,402,1,0,1,1,0,1,15,12,0
28/2/2021,Johor,1222,0,61,61,0,55,55,458,0,0
28/2/2021,Kedah,672,0,4,4,0,34,34,58,0,0
28/2/2021,Kelantan,587,1,26,27,0,26,26,119,1,1
28/2/2021,Melaka,126,0,2,2,0,13,13,34,0,0
28/2/2021,Negeri Sembilan,10,0,0,0,0,0,0,6,0,0
28/2/2021,Pahang,722,0,6,6,0,7,7,31,0,0
28/2/2021,Perak,927,0,67,67,0,82,82,637,0,142
28/2/2021,Perlis,314,0,0,0,0,0,0,9,0,0
28/2/2021,Pulau Pinang,1215,0,104,104,0,64,64,442,0,0
28/2/2021,Sabah,4913,0,51,51,0,120,120,456,6,0
28/2/2021,Sarawak,3637,4,39,43,1,23,24,1568,185,44
28/2/2021,Selangor,7429,4,1095,1099,4,1722,1726,5384,25,40
28/2/2021,Terengganu,1509,0,10,10,0,11,11,85,0,0
28/2/2021,W.P. Labuan,402,1,0,1,0,3,3,13,13,0
1/3/2021,Johor,1222,0,55,55,0,99,99,414,0,0
1/3/2021,Kedah,672,0,7,7,0,20,20,45,0,0
1/3/2021,Kelantan,587,2,17,19,1,17,18,119,2,6
1/3/2021,Melaka,126,0,2,2,0,15,15,21,0,0
1/3/2021,Negeri Sembilan,10,0,0,0,0,0,0,6,0,0
1/3/2021,Pahang,722,0,3,3,0,5,5,29,0,0
1/3/2021,Perak,927,0,107,107,0,133,133,545,0,151
1/3/2021,Perlis,314,0,1,1,0,0,0,10,0,0
1/3/2021,Pulau Pinang,1215,0,92,92,0,94,94,443,0,0
1/3/2021,Sabah,4913,0,49,49,0,46,46,474,6,0
1/3/2021,Sarawak,3637,7,31,38,6,23,29,1534,195,46
1/3/2021,Selangor,7429,5,797,802,4,798,802,5385,24,40
1/3/2021,Terengganu,1509,0,8,8,0,20,20,73,0,0
1/3/2021,W.P. Labuan,402,0,2,2,1,3,4,12,10,0
2/3/2021,Johor,1822,0,58,58,0,78,78,409,0,0
2/3/2021,Kedah,672,0,5,5,0,7,7,43,0,0
2/3/2021,Kelantan,587,1,23,24,0,20,20,122,3,6
2/3/2021,Melaka,126,0,2,2,0,1,1,22,0,0
2/3/2021,Negeri Sembilan,10,0,0,0,0,0,0,6,0,0
2/3/2021,Pahang,722,0,3,3,0,4,4,28,0,0
2/3/2021,Perak,977,0,126,126,0,64,64,606,0,168
2/3/2021,Perlis,314,0,0,0,0,1,1,9,0,0
2/3/2021,Pulau Pinang,1215,0,48,48,0,44,44,453,0,0
2/3/2021,Sabah,4257,1,53,54,1,61,62,464,7,0
2/3/2021,Sarawak,3682,4,33,37,10,10,20,1507,173,49
2/3/2021,Selangor,7429,1,592,593,3,762,765,5216,21,40
2/3/2021,Terengganu,1509,0,8,8,0,24,24,57,0,0
2/3/2021,W.P. Labuan,402,5,0,5,1,0,1,12,14,0
3/3/2021,Johor,1822,0,54,54,0,58,58,402,0,0
3/3/2021,Kedah,672,0,6,6,0,9,9,40,0,0
3/3/2021,Kelantan,587,0,25,25,1,12,13,134,2,48
3/3/2021,Melaka,126,0,2,2,0,1,1,23,0,0
3/3/2021,Negeri Sembilan,10,0,5,5,0,0,0,11,0,0
3/3/2021,Pahang,722,0,1,1,0,0,0,29,0,0
3/3/2021,Perak,977,0,8,8,0,151,151,436,0,179
3/3/2021,Perlis,314,0,0,0,0,0,0,9,0,0
3/3/2021,Pulau Pinang,1215,0,90,90,0,64,64,479,0,0
3/3/2021,Sabah,4257,0,41,41,0,67,67,437,8,0
3/3/2021,Sarawak,3682,11,59,70,7,54,61,1534,185,54
3/3/2021,Selangor,7847,3,778,781,2,484,486,5510,22,40
3/3/2021,Terengganu,1509,0,5,5,0,6,6,56,1,0
3/3/2021,W.P. Labuan,402,16,0,16,1,5,6,6,29,0
4/3/2021,Johor,1822,0,49,49,0,77,77,376,0,0
4/3/2021,Kedah,672,0,5,5,0,1,1,44,0,0
4/3/2021,Kelantan,587,0,15,15,0,17,17,132,0,9
4/3/2021,Melaka,166,0,30,30,0,13,13,40,0,0
4/3/2021,Negeri Sembilan,11,0,0,0,0,0,0,11,0,0
4/3/2021,Pahang,722,0,13,13,0,8,8,33,0,0
4/3/2021,Perak,977,0,18,18,0,56,56,397,0,187
4/3/2021,Perlis,314,0,0,0,0,2,2,7,0,0
4/3/2021,Pulau Pinang,1215,0,68,68,0,97,97,443,0,0
4/3/2021,Sabah,4257,2,54,56,1,51,52,433,10,0
4/3/2021,Sarawak,3682,6,8,14,1,28,29,1451,164,53
4/3/2021,Selangor,7847,4,490,494,4,1553,1557,4449,20,40
4/3/2021,Terengganu,1509,0,1,1,0,12,12,45,1,0
4/3/2021,W.P. Labuan,402,6,0,6,0,3,3,3,35,0
5/3/2021,Johor,1822,0,61,61,0,69,69,368,0,0
5/3/2021,Kedah,672,0,2,2,0,2,2,44,0,0
5/3/2021,Kelantan,587,1,25,26,1,17,18,140,2,9
5/3/2021,Melaka,166,0,7,7,0,3,3,44,0,0
5/3/2021,Negeri Sembilan,11,0,0,0,0,0,0,11,0,0
5/3/2021,Pahang,722,0,5,5,0,3,3,47,0,0
5/3/2021,Perak,977,0,71,71,0,79,79,388,1,170
5/3/2021,Perlis,314,0,0,0,0,2,2,5,0,0
5/3/2021,Pulau Pinang,1215,0,235,235,0,70,70,605,0,0
5/3/2021,Sabah,4257,0,60,60,2,55,57,438,7,0
5/3/2021,Sarawak,3612,5,63,68,4,25,29,1610,157,57
5/3/2021,Selangor,7847,6,557,563,8,1253,1261,3754,17,40
5/3/2021,Terengganu,1509,3,0,3,0,9,9,39,1,0
5/3/2021,W.P. Labuan,402,13,1,14,0,1,1,3,48,0
6/3/2021,Johor,1822,0,38,38,0,60,60,346,0,0
6/3/2021,Kedah,672,0,0,0,0,11,11,33,0,0
6/3/2021,Kelantan,343,3,32,35,0,16,16,156,5,10
6/3/2021,Melaka,166,0,9,9,0,6,6,47,0,0
6/3/2021,Negeri Sembilan,11,0,0,0,0,7,7,4,0,0
6/3/2021,Pahang,722,0,5,5,0,3,3,52,2,0
6/3/2021,Perak,977,0,44,44,0,53,53,377,2,151
6/3/2021,Perlis,314,8,0,8,0,0,0,5,8,0
6/3/2021,Pulau Pinang,1215,0,127,127,0,76,76,657,0,0
6/3/2021,Sabah,4257,6,61,67,1,73,74,426,10,0
6/3/2021,Sarawak,3010,7,21,28,6,26,32,1199,131,56
6/3/2021,Selangor,7847,7,573,580,3,836,839,3491,21,40
6/3/2021,Terengganu,1509,0,22,22,0,2,2,59,1,0
6/3/2021,W.P. Labuan,402,3,0,3,2,1,3,2,49,0
7/3/2021,Johor,1822,0,44,44,0,74,74,316,0,0
7/3/2021,Kedah,672,0,2,2,0,5,5,30,0,0
7/3/2021,Kelantan,343,2,6,8,1,18,19,144,6,7
7/3/2021,Melaka,166,0,7,7,0,1,1,53,0,0
7/3/2021,Negeri Sembilan,11,0,0,0,0,0,0,4,0,0
7/3/2021,Pahang,722,0,5,5,0,2,2,54,2,0
7/3/2021,Perak,977,0,35,35,0,99,99,312,0,152
7/3/2021,Perlis,314,12,17,29,0,0,0,24,7,0
7/3/2021,Pulau Pinang,1215,0,56,56,0,82,82,631,0,0
7/3/2021,Sabah,4257,4,54,58,1,71,72,404,14,0
7/3/2021,Sarawak,3682,7,50,57,7,18,25,1651,158,56
7/3/2021,Selangor,7847,6,488,494,4,827,831,3152,23,40
7/3/2021,Terengganu,1509,0,2,2,0,4,4,57,1,0
7/3/2021,W.P. Labuan,402,0,0,0,8,0,8,2,42,0
8/3/2021,Johor,1822,0,65,65,0,52,52,328,0,0
8/3/2021,Kedah,672,0,2,2,0,5,5,27,0,0
8/3/2021,Kelantan,343,0,6,6,3,23,26,127,3,6
8/3/2021,Melaka,166,0,0,0,0,9,9,44,0,0
8/3/2021,Negeri Sembilan,11,0,0,0,0,0,0,4,0,0
8/3/2021,Pahang,722,0,4,4,1,7,8,38,1,12
8/3/2021,Perak,977,0,21,21,0,103,103,229,0,159
8/3/2021,Perlis,314,0,12,12,0,0,0,35,1,0
8/3/2021,Pulau Pinang,1025,0,120,120,0,77,77,670,0,0
8/3/2021,Sabah,4257,1,70,71,1,89,90,374,10,0
8/3/2021,Sarawak,3682,1,45,46,2,33,35,1612,156,57
8/3/2021,Selangor,7847,1,294,295,1,467,468,2979,23,40
8/3/2021,Terengganu,1509,0,8,8,0,8,8,56,1,0
8/3/2021,W.P. Labuan,402,0,7,7,13,0,13,9,27,0
9/3/2021,Johor,1822,0,58,58,0,40,40,346,0,0
9/3/2021,Kedah,672,0,4,4,0,7,7,26,0,0
9/3/2021,Kelantan,343,0,16,16,1,17,18,126,2,4
9/3/2021,Melaka,166,0,0,0,0,11,11,33,0,0
9/3/2021,Negeri Sembilan,40,0,32,32,0,4,4,32,0,0
9/3/2021,Pahang,722,0,16,16,0,8,8,45,1,0
9/3/2021,Perak,977,0,27,27,0,23,23,231,2,142
9/3/2021,Perlis,314,1,0,1,0,1,1,39,2,0
9/3/2021,Pulau Pinang,1025,0,52,52,0,49,49,673,0,0
9/3/2021,Sabah,4257,1,42,43,3,48,51,374,6,0
9/3/2021,Sarawak,3682,1,15,16,0,86,86,1544,145,59
9/3/2021,Selangor,7847,5,533,538,7,494,501,2991,21,40
9/3/2021,Terengganu,1509,2,10,12,1,6,7,61,2,0
9/3/2021,W.P. Labuan,402,4,0,4,3,0,3,9,28,0
10/3/2021,Johor,1822,0,60,60,0,45,45,359,0,0
10/3/2021,Kedah,672,0,3,3,0,5,5,24,0,0
10/3/2021,Kelantan,343,0,5,5,0,18,18,113,2,4
10/3/2021,Melaka,166,0,1,1,0,11,11,23,0,0
10/3/2021,Negeri Sembilan,40,0,0,0,0,0,0,32,0,0
10/3/2021,Pahang,722,0,0,0,0,5,5,42,1,0
10/3/2021,Perak,977,0,18,18,0,20,20,229,1,167
10/3/2021,Perlis,314,0,5,5,0,3,3,41,0,0
10/3/2021,Pulau Pinang,1025,0,80,80,0,128,128,627,0,0
10/3/2021,Sabah,4257,6,43,49,1,42,43,374,12,0
10/3/2021,Sarawak,3732,6,38,44,3,35,38,1717,148,62
10/3/2021,Selangor,7847,4,561,565,1,406,407,3148,22,40
10/3/2021,Terengganu,1509,0,28,28,0,12,12,77,3,0
10/3/2021,W.P. Labuan,402,1,0,1,0,0,0,9,29,0
11/3/2021,Johor,1930,0,23,23,0,54,54,360,0,0
11/3/2021,Kedah,672,0,5,5,0,2,2,27,0,0
11/3/2021,Kelantan,343,0,7,7,1,26,27,94,1,3
11/3/2021,Melaka,166,0,4,4,0,14,14,13,0,0
11/3/2021,Negeri Sembilan,40,0,0,0,0,0,0,32,0,0
11/3/2021,Pahang,722,0,1,1,0,9,9,34,1,0
11/3/2021,Perak,977,0,21,21,0,89,89,162,0,175
11/3/2021,Perlis,314,0,0,0,0,0,0,42,0,0
11/3/2021,Pulau Pinang,1025,0,24,24,0,290,290,413,0,0
11/3/2021,Sabah,4257,6,43,49,1,76,77,358,16,0
11/3/2021,Sarawak,3732,4,82,86,1,18,19,1634,148,41
11/3/2021,Selangor,7847,3,349,352,4,517,521,2984,17,40
11/3/2021,Terengganu,1509,0,8,8,0,6,6,79,3,0
11/3/2021,W.P. Labuan,402,1,0,1,5,1,6,10,25,0
12/3/2021,Johor,1356,0,9,9,0,3,3,172,0,0
12/3/2021,Kedah,672,0,3,3,0,6,6,24,0,0
12/3/2021,Kelantan,343,0,7,7,1,14,15,87,0,3
12/3/2021,Melaka,216,0,57,57,0,6,6,64,0,0
12/3/2021,Negeri Sembilan,40,0,0,0,0,0,0,32,0,0
12/3/2021,Pahang,722,0,6,6,1,6,7,36,0,0
12/3/2021,Perak,977,0,40,40,0,9,9,192,3,166
12/3/2021,Perlis,314,1,2,3,0,0,0,44,1,0
12/3/2021,Pulau Pinang,1025,0,62,62,0,115,115,362,0,0
12/3/2021,Sabah,4257,2,31,33,5,59,64,330,14,33
12/3/2021,Sarawak,3732,13,30,43,1,33,34,1590,155,44
12/3/2021,Selangor,7847,5,419,424,0,622,622,2781,22,40
12/3/2021,Terengganu,1509,0,8,8,0,1,1,86,3,0
12/3/2021,W.P. Labuan,402,3,0,3,5,3,8,7,23,0
13/3/2021,Johor,2106,0,25,25,0,75,75,328,0,0
13/3/2021,Kedah,672,0,5,5,0,3,3,26,0,0
13/3/2021,Kelantan,343,0,13,13,0,26,26,74,0,0
13/3/2021,Melaka,216,0,1,1,0,0,0,65,0,0
13/3/2021,Negeri Sembilan,40,0,0,0,0,0,0,32,0,0
13/3/2021,Pahang,722,0,2,2,0,12,12,26,0,0
13/3/2021,Perak,977,0,76,76,0,29,29,239,3,147
13/3/2021,Perlis,314,0,21,21,0,1,1,67,1,0
13/3/2021,Pulau Pinang,1981,0,69,69,0,81,81,475,0,0
13/3/2021,Sabah,4257,0,51,51,0,61,61,322,12,0
13/3/2021,Sarawak,3732,12,14,26,4,22,26,1518,153,60
13/3/2021,Selangor,7847,4,408,412,7,446,453,2744,21,40
13/3/2021,Terengganu,1509,0,14,14,0,3,3,97,3,0
13/3/2021,W.P. Labuan,402,4,3,7,7,4,11,5,20,0
14/3/2021,Johor,2106,0,47,47,0,44,44,329,0,0
14/3/2021,Kedah,672,0,5,5,0,3,3,30,0,0
14/3/2021,Kelantan,343,3,16,19,0,26,26,64,3,1
14/3/2021,Melaka,216,0,0,0,0,1,1,64,0,0
14/3/2021,Negeri Sembilan,40,0,0,0,0,0,0,32,0,0
14/3/2021,Pahang,722,2,5,7,0,9,9,22,2,0
14/3/2021,Perak,977,0,63,63,0,25,25,279,0,153
14/3/2021,Perlis,314,0,29,29,1,3,4,90,0,0
14/3/2021,Pulau Pinang,1981,0,134,134,0,49,49,561,0,0
14/3/2021,Sabah,4257,2,29,31,2,63,65,290,13,0
14/3/2021,Sarawak,3732,4,35,39,3,34,37,1580,168,66
14/3/2021,Selangor,7847,4,204,208,4,573,577,2379,18,40
14/3/2021,Terengganu,1509,0,10,10,0,20,20,87,3,0
14/3/2021,W.P. Labuan,402,1,1,2,0,1,1,5,21,0
15/3/2021,Johor,2108,0,45,45,0,69,69,301,0,0
15/3/2021,Kedah,672,0,11,11,0,3,3,38,0,0
15/3/2021,Kelantan,343,0,16,16,2,6,8,74,1,2
15/3/2021,Melaka,216,0,3,3,0,2,2,65,0,0
15/3/2021,Negeri Sembilan,40,0,0,0,0,0,0,32,0,0
15/3/2021,Pahang,722,2,3,5,0,5,5,29,4,0
15/3/2021,Perak,977,0,29,29,0,16,16,292,0,159
15/3/2021,Perlis,314,0,0,0,0,7,7,79,1,0
15/3/2021,Pulau Pinang,1981,0,139,139,0,86,86,602,0,0
15/3/2021,Sabah,4207,0,30,30,0,51,51,270,12,0
15/3/2021,Sarawak,3732,4,26,30,1,46,47,1517,172,59
15/3/2021,Selangor,7847,7,251,258,4,495,499,2135,21,40
15/3/2021,Terengganu,1509,0,19,19,1,4,5,102,2,0
15/3/2021,W.P. Labuan,402,2,0,2,3,0,3,5,20,0
16/3/2021,Johor,2108,0,10,10,0,32,32,272,0,0
16/3/2021,Kedah,672,0,7,7,0,6,6,39,0,0
16/3/2021,Kelantan,343,0,16,16,1,10,11,80,0,2
16/3/2021,Melaka,216,0,0,0,0,0,0,65,0,0
16/3/2021,Negeri Sembilan,40,0,0,0,0,0,0,32,0,0
16/3/2021,Pahang,722,0,0,0,1,5,6,15,3,0
16/3/2021,Perak,977,0,14,14,0,25,25,280,0,147
16/3/2021,Perlis,314,1,0,1,0,12,12,67,0,0
16/3/2021,Pulau Pinang,1981,0,82,82,0,70,70,619,0,0
16/3/2021,Sabah,4107,1,15,16,1,45,46,236,12,0
16/3/2021,Sarawak,3732,12,50,62,3,34,37,1563,167,58
16/3/2021,Selangor,7847,5,322,327,2,345,347,2112,24,40
16/3/2021,Terengganu,1509,0,13,13,0,2,2,113,2,0
16/3/2021,W.P. Labuan,402,2,1,3,2,0,2,6,20,0
17/3/2021,Johor,2108,0,152,152,0,50,50,237,0,0
17/3/2021,Kedah,672,0,6,6,0,3,3,42,0,0
17/3/2021,Kelantan,343,0,29,29,0,10,10,99,0,3
17/3/2021,Melaka,236,0,0,0,0,2,2,67,0,0
17/3/2021,Negeri Sembilan,80,0,42,42,0,0,0,74,0,0
17/3/2021,Pahang,722,0,0,0,0,1,1,15,3,0
17/3/2021,Perak,977,0,21,21,0,21,21,280,1,158
17/3/2021,Perlis,314,0,1,1,0,8,8,60,1,0
17/3/2021,Pulau Pinang,1981,0,83,83,0,40,40,662,0,0
17/3/2021,Sabah,3800,0,19,19,0,38,38,218,6,0
17/3/2021,Sarawak,3732,9,31,40,5,53,58,1550,166,58
17/3/2021,Selangor,7847,8,443,451,0,173,173,2382,32,40
17/3/2021,Terengganu,1509,0,12,12,0,7,7,117,3,0
17/3/2021,W.P. Labuan,402,2,1,3,8,0,8,7,12,0
18/3/2021,Johor,2108,0,32,32,0,54,54,213,0,0
18/3/2021,Kedah,672,0,8,8,0,6,6,44,0,0
18/3/2021,Kelantan,343,0,11,11,0,5,5,105,0,4
18/3/2021,Melaka,236,0,17,17,0,4,4,80,0,0
18/3/2021,Negeri Sembilan,80,0,0,0,0,11,11,63,0,0
18/3/2021,Pahang,722,0,11,11,0,0,0,26,3,0
18/3/2021,Perak,977,0,19,19,0,19,19,280,1,179
18/3/2021,Perlis,314,0,0,0,1,0,1,60,0,0
18/3/2021,Pulau Pinang,1981,0,84,84,0,68,68,684,0,0
18/3/2021,Sabah,3800,1,29,30,1,24,25,223,5,0
18/3/2021,Sarawak,3732,5,27,32,5,53,58,1510,152,60
18/3/2021,Selangor,5473,2,300,302,3,553,556,2135,25,40
18/3/2021,Terengganu,1509,1,10,11,1,33,34,94,3,0
18/3/2021,W.P. Labuan,402,9,0,9,2,0,2,7,19,0
19/3/2021,Johor,2108,0,36,36,0,18,18,230,0,0
19/3/2021,Kedah,672,0,8,8,0,4,4,49,0,0
19/3/2021,Kelantan,343,4,5,9,0,10,10,100,4,4
19/3/2021,Melaka,236,0,0,0,0,56,56,24,0,0
19/3/2021,Negeri Sembilan,80,0,0,0,0,10,10,53,0,0
19/3/2021,Pahang,722,0,10,10,0,2,2,34,3,0
19/3/2021,Perak,1069,0,8,8,0,47,47,241,2,177
19/3/2021,Perlis,314,0,0,0,0,12,12,48,0,0
19/3/2021,Pulau Pinang,1981,0,26,26,0,130,130,529,0,0
19/3/2021,Sabah,3730,0,51,51,0,53,53,218,4,0
19/3/2021,Sarawak,4195,4,34,38,4,23,27,1635,148,60
19/3/2021,Selangor,5473,5,469,474,10,482,492,2123,19,40
19/3/2021,Terengganu,1509,0,5,5,0,2,2,97,3,0
19/3/2021,W.P. Labuan,402,5,4,9,0,3,3,8,25,0
20/3/2021,Johor,2108,0,24,24,0,18,18,236,0,0
20/3/2021,Kedah,672,0,3,3,0,5,5,47,0,0
20/3/2021,Kelantan,343,1,12,13,0,14,14,98,5,4
20/3/2021,Melaka,236,0,2,2,0,1,1,25,0,0
20/3/2021,Negeri Sembilan,80,0,0,0,0,11,11,42,0,0
20/3/2021,Pahang,722,0,0,0,0,8,8,12,0,0
20/3/2021,Perak,1069,0,7,7,0,88,88,161,0,160
20/3/2021,Perlis,314,0,0,0,0,43,43,4,0,0
20/3/2021,Pulau Pinang,1981,0,70,70,0,177,177,425,0,0
20/3/2021,Sabah,3730,0,26,26,0,31,31,210,4,0
20/3/2021,Sarawak,4195,6,202,208,1,33,34,1873,159,62
20/3/2021,Selangor,5473,6,436,442,1,418,419,2174,24,40
20/3/2021,Terengganu,1509,0,4,4,2,5,7,96,1,0
20/3/2021,W.P. Labuan,402,0,0,0,0,0,0,8,25,0
21/3/2021,Johor,2108,0,20,20,0,28,28,225,0,0
21/3/2021,Kedah,672,0,7,7,0,6,6,48,0,0
21/3/2021,Kelantan,343,3,34,37,0,15,15,117,8,7
21/3/2021,Melaka,236,0,0,0,0,3,3,30,0,0
21/3/2021,Negeri Sembilan,80,0,0,0,0,0,0,42,0,0
21/3/2021,Pahang,722,0,3,3,2,4,6,27,1,0
21/3/2021,Perak,1069,0,43,43,0,65,65,139,0,164
21/3/2021,Perlis,314,0,4,4,0,0,0,9,0,0
21/3/2021,Pulau Pinang,1441,0,61,61,0,106,106,384,0,0
21/3/2021,Sabah,3730,0,45,45,2,38,40,219,2,0
21/3/2021,Sarawak,4195,4,189,193,1,66,67,1876,172,66
21/3/2021,Selangor,5473,4,425,429,3,378,381,2211,25,40
21/3/2021,Terengganu,1509,0,14,14,1,10,11,100,0,0
21/3/2021,W.P. Labuan,402,0,1,1,0,1,1,8,24,0
22/3/2021,Johor,1636,0,49,49,0,61,61,209,0,0
22/3/2021,Kedah,672,0,5,5,0,3,3,48,0,0
22/3/2021,Kelantan,343,0,10,10,5,14,19,113,3,11
22/3/2021,Melaka,236,0,1,1,0,2,2,29,0,0
22/3/2021,Negeri Sembilan,80,0,0,0,0,0,0,42,0,0
22/3/2021,Pahang,722,0,9,9,0,0,0,36,1,0
22/3/2021,Perak,1069,0,29,29,0,15,15,152,0,150
22/3/2021,Perlis,314,0,0,0,0,3,3,6,0,0
22/3/2021,Pulau Pinang,2031,0,44,44,0,34,34,383,0,0
22/3/2021,Sabah,3730,1,21,22,0,22,22,219,3,0
22/3/2021,Sarawak,4195,7,15,22,7,37,44,1883,168,69
22/3/2021,Selangor,5473,3,307,310,4,361,365,2157,24,40
22/3/2021,Terengganu,1509,2,13,15,0,15,15,98,2,0
22/3/2021,W.P. Labuan,402,5,0,5,4,1,5,7,25,0
23/3/2021,Johor,1636,0,21,21,0,12,12,217,0,0
23/3/2021,Kedah,672,0,9,9,0,7,7,50,0,0
23/3/2021,Kelantan,343,0,28,28,1,18,19,123,2,13
23/3/2021,Melaka,236,0,2,2,0,0,0,33,0,0
23/3/2021,Negeri Sembilan,80,0,0,0,0,0,0,41,0,0
23/3/2021,Pahang,722,10,30,40,1,2,3,64,10,0
23/3/2021,Perak,1069,0,7,7,0,20,20,138,2,182
23/3/2021,Perlis,314,0,0,0,0,0,0,6,0,0
23/3/2021,Pulau Pinang,2031,0,46,46,0,72,72,747,0,0
23/3/2021,Sabah,3730,2,38,40,0,16,16,244,9,0
23/3/2021,Sarawak,4195,4,13,17,4,32,36,1866,142,64
23/3/2021,Selangor,5473,2,466,468,7,236,243,2386,19,40
23/3/2021,Terengganu,1509,0,2,2,0,17,17,83,4,0
23/3/2021,W.P. Labuan,402,2,8,10,2,0,2,15,25,0
24/3/2021,Johor,1636,0,19,19,0,24,24,212,0,0
24/3/2021,Kedah,672,0,5,5,0,5,5,50,0,0
24/3/2021,Kelantan,343,6,29,35,1,26,27,126,7,15
24/3/2021,Melaka,236,0,1,1,0,1,1,33,0,0
24/3/2021,Negeri Sembilan,80,0,14,14,0,0,0,55,0,0
24/3/2021,Pahang,762,5,31,36,0,0,0,95,15,0
24/3/2021,Perak,1069,0,9,9,0,10,10,139,1,187
24/3/2021,Perlis,314,0,0,0,0,0,0,5,0,0
24/3/2021,Pulau Pinang,2031,0,53,53,0,42,42,755,0,0
24/3/2021,Sabah,3730,2,25,27,0,16,16,255,11,0
24/3/2021,Sarawak,4720,12,18,30,5,21,26,1853,222,66
24/3/2021,Selangor,5473,4,436,440,2,128,130,2695,21,40
24/3/2021,Terengganu,1509,0,4,4,0,22,22,65,4,0
24/3/2021,W.P. Labuan,402,0,0,0,0,0,0,15,25,0
25/3/2021,Johor,1636,0,42,42,0,9,9,244,0,0
25/3/2021,Kedah,672,0,8,8,0,7,7,50,0,0
25/3/2021,Kelantan,343,2,33,35,1,27,28,132,8,18
25/3/2021,Melaka,236,0,7,7,0,2,2,37,0,0
25/3/2021,Negeri Sembilan,80,0,0,0,0,3,3,52,0,0
25/3/2021,Pahang,762,2,36,38,0,6,6,125,17,0
25/3/2021,Perak,1069,0,24,24,0,8,8,156,0,158
25/3/2021,Perlis,314,0,0,0,0,0,0,5,0,0
25/3/2021,Pulau Pinang,2031,0,85,85,0,135,135,706,0,0
25/3/2021,Sabah,3730,8,46,54,1,48,49,237,17,0
25/3/2021,Sarawak,4861,17,79,96,1,45,46,1864,223,59
25/3/2021,Selangor,8483,3,448,451,3,439,442,2697,21,40
25/3/2021,Terengganu,1509,0,4,4,2,9,11,60,2,0
25/3/2021,W.P. Labuan,402,8,1,9,0,1,1,27,27,0
26/3/2021,Johor,1641,0,79,79,0,34,34,285,0,0
26/3/2021,Kedah,672,0,10,10,0,11,11,48,0,0
26/3/2021,Kelantan,343,3,54,57,2,15,17,171,9,16
26/3/2021,Melaka,236,0,25,25,0,17,17,45,0,0
26/3/2021,Negeri Sembilan,80,0,0,0,0,4,4,48,0,0
26/3/2021,Pahang,762,1,11,12,4,21,25,115,14,0
26/3/2021,Perak,1069,0,9,9,0,24,24,139,0,174
26/3/2021,Perlis,314,0,1,1,0,0,0,5,0,0
26/3/2021,Pulau Pinang,2031,0,53,53,0,135,135,629,0,0
26/3/2021,Sabah,3730,2,33,35,0,47,47,227,20,0
26/3/2021,Sarawak,4861,4,35,39,6,55,61,1859,232,56
26/3/2021,Selangor,8483,5,407,412,4,392,396,2712,22,40
26/3/2021,Terengganu,1509,0,4,4,0,14,14,50,2,0
26/3/2021,W.P. Labuan,402,6,2,8,1,1,2,28,32,0
27/3/2021,Johor,1641,0,39,39,0,44,44,280,0,0
27/3/2021,Kedah,672,0,3,3,0,4,4,47,0,0
27/3/2021,Kelantan,343,3,31,34,0,16,16,186,10,17
27/3/2021,Melaka,236,0,3,3,0,9,9,39,0,0
27/3/2021,Negeri Sembilan,80,0,0,0,0,6,6,42,0,0
27/3/2021,Pahang,762,3,7,10,4,16,20,117,17,0
27/3/2021,Perak,1069,0,34,34,0,14,14,156,0,183
27/3/2021,Perlis,314,0,0,0,0,0,0,5,0,0
27/3/2021,Pulau Pinang,2031,0,12,12,0,73,73,536,0,0
27/3/2021,Sabah,3730,0,46,46,0,31,31,250,16,0
27/3/2021,Sarawak,4861,9,23,32,6,29,35,1809,190,53
27/3/2021,Selangor,8483,6,317,323,4,610,614,2419,24,40
27/3/2021,Terengganu,1509,0,0,0,0,5,5,45,2,0
27/3/2021,W.P. Labuan,402,0,7,7,5,2,7,33,22,0
28/3/2021,Johor,1641,0,20,20,0,30,30,269,0,0
28/3/2021,Kedah,672,0,6,6,0,5,5,48,0,0
28/3/2021,Kelantan,343,0,36,36,1,8,9,214,9,16
28/3/2021,Melaka,236,0,0,0,0,3,3,36,0,0
28/3/2021,Negeri Sembilan,80,0,0,0,0,0,0,42,0,0
28/3/2021,Pahang,762,0,6,6,1,1,2,122,16,0
28/3/2021,Perak,1069,0,7,7,0,47,47,114,2,193
28/3/2021,Perlis,314,0,0,0,0,0,0,5,0,0
28/3/2021,Pulau Pinang,2031,0,137,137,0,138,138,579,0,0
28/3/2021,Sabah,3730,0,25,25,1,40,41,253,16,0
28/3/2021,Sarawak,4861,9,43,52,5,32,37,1848,207,56
28/3/2021,Selangor,8483,3,251,254,6,530,536,2140,21,40
28/3/2021,Terengganu,1509,0,0,0,0,2,2,43,2,0
28/3/2021,W.P. Labuan,402,4,0,4,0,8,8,25,26,0
29/3/2021,Johor,1641,0,24,24,0,38,38,254,0,0
29/3/2021,Kedah,672,0,10,10,0,12,12,47,0,0
29/3/2021,Kelantan,370,5,63,68,8,35,43,242,6,9
29/3/2021,Melaka,236,0,4,4,0,2,2,38,0,0
29/3/2021,Negeri Sembilan,80,0,0,0,0,0,0,42,0,0
29/3/2021,Pahang,762,3,16,19,3,13,16,125,16,0
29/3/2021,Perak,1069,0,2,2,0,12,12,103,2,190
29/3/2021,Perlis,314,0,0,0,0,0,0,5,0,0
29/3/2021,Pulau Pinang,2031,0,102,102,0,84,84,598,0,0
29/3/2021,Sabah,3730,0,23,23,2,18,20,238,12,0
29/3/2021,Sarawak,4861,3,217,220,5,28,33,2074,198,57
29/3/2021,Selangor,8483,0,159,159,3,357,360,1941,18,40
29/3/2021,Terengganu,1509,0,2,2,0,14,14,31,2,0
29/3/2021,W.P. Labuan,402,0,7,7,1,6,7,26,22,0
30/3/2021,Johor,1641,0,30,30,0,21,21,263,0,0
30/3/2021,Kedah,672,0,5,5,3,4,7,51,0,0
30/3/2021,Kelantan,370,2,25,27,0,15,15,252,8,7
30/3/2021,Melaka,236,0,2,2,0,10,10,30,0,0
30/3/2021,Negeri Sembilan,80,0,6,6,0,20,20,28,0,0
30/3/2021,Pahang,762,16,2,18,2,24,26,103,30,0
30/3/2021,Perak,1069,0,12,12,0,6,6,107,2,192
30/3/2021,Perlis,314,0,0,0,0,0,0,5,0,0
30/3/2021,Pulau Pinang,2031,0,150,150,0,160,160,489,0,0
30/3/2021,Sabah,3670,2,30,32,2,44,46,223,12,0
30/3/2021,Sarawak,4861,8,17,25,8,54,62,1975,193,64
30/3/2021,Selangor,8483,3,236,239,3,388,391,1791,16,40
30/3/2021,Terengganu,1509,0,0,0,2,14,16,16,0,0
30/3/2021,W.P. Labuan,402,0,2,2,0,1,1,27,27,0
31/3/2021,Johor,1651,0,61,61,0,24,24,285,0,0
31/3/2021,Kedah,672,1,25,26,0,2,2,75,1,0
31/3/2021,Kelantan,398,0,22,22,0,20,20,254,8,6
31/3/2021,Melaka,236,0,21,21,0,1,1,50,0,0
31/3/2021,Negeri Sembilan,80,0,4,4,0,5,5,27,0,0
31/3/2021,Pahang,762,1,7,8,9,10,19,91,19,0
31/3/2021,Perak,1069,0,25,25,0,21,21,113,2,187
31/3/2021,Perlis,314,0,0,0,0,0,0,5,0,0
31/3/2021,Pulau Pinang,2031,0,109,109,0,73,73,631,0,0
31/3/2021,Sabah,3470,0,20,20,0,18,18,228,11,0
31/3/2021,Sarawak,4861,4,3,7,1,27,28,2018,227,72
31/3/2021,Selangor,8483,6,632,638,1,270,271,2154,20,40
31/3/2021,Terengganu,1509,0,1,1,0,1,1,16,0,0
31/3/2021,W.P. Labuan,382,18,0,18,1,3,4,25,44,0
1/4/2021,Johor,1651,0,25,25,0,30,30,279,0,0
1/4/2021,Kedah,672,0,8,8,0,8,8,75,1,0
1/4/2021,Kelantan,398,1,21,22,4,33,37,242,5,4
1/4/2021,Melaka,236,0,6,6,0,4,4,52,0,0
1/4/2021,Negeri Sembilan,80,0,0,0,0,0,0,27,0,0
1/4/2021,Pahang,762,1,31,32,1,35,36,88,20,0
1/4/2021,Perak,1069,0,16,16,0,20,20,90,0,182
1/4/2021,Perlis,314,0,0,0,0,0,0,5,0,0
1/4/2021,Pulau Pinang,2031,0,123,123,0,121,121,632,0,0
1/4/2021,Sabah,3470,0,42,42,0,38,38,258,11,0
1/4/2021,Sarawak,4861,4,22,26,5,16,21,1804,195,258
1/4/2021,Selangor,8483,0,288,288,8,441,449,2070,12,40
1/4/2021,Terengganu,1509,0,0,0,0,3,3,13,0,0
1/4/2021,W.P. Labuan,382,11,12,23,1,8,9,29,50,0
2/4/2021,Johor,1658,0,51,51,0,46,46,284,0,0
2/4/2021,Kedah,672,0,9,9,0,13,13,71,1,0
2/4/2021,Kelantan,398,0,10,10,2,28,30,224,3,1
2/4/2021,Melaka,236,0,0,0,0,17,17,35,0,0
2/4/2021,Negeri Sembilan,80,0,0,0,0,3,3,24,0,0
2/4/2021,Pahang,762,1,6,7,4,20,24,74,17,0
2/4/2021,Perak,1069,0,5,5,0,29,29,85,1,181
2/4/2021,Perlis,314,0,1,1,0,4,4,2,0,0
2/4/2021,Pulau Pinang,2031,0,147,147,0,169,169,609,0,0
2/4/2021,Sabah,3410,0,62,62,0,45,45,279,4,0
2/4/2021,Sarawak,4861,4,5,9,4,21,25,1717,207,78
2/4/2021,Selangor,8483,1,415,416,5,369,374,2126,8,40
2/4/2021,Terengganu,1509,0,4,4,0,10,10,7,0,0
2/4/2021,W.P. Labuan,382,5,4,9,2,4,6,29,58,0
3/4/2021,Johor,1658,0,23,23,0,10,10,295,0,0
3/4/2021,Kedah,672,0,10,10,0,16,16,66,0,0
3/4/2021,Kelantan,398,0,14,14,0,32,32,206,3,0
3/4/2021,Melaka,236,0,12,12,0,1,1,46,0,0
3/4/2021,Negeri Sembilan,80,0,0,0,0,0,0,24,0,0
3/4/2021,Pahang,762,3,29,32,4,12,16,91,16,0
3/4/2021,Perak,1069,0,1,1,0,3,3,75,0,187
3/4/2021,Perlis,314,0,0,0,0,0,0,2,0,0
3/4/2021,Pulau Pinang,2031,0,97,97,0,165,165,545,0,0
3/4/2021,Sabah,3410,0,22,22,1,28,29,278,4,0
3/4/2021,Sarawak,4861,5,19,24,2,38,40,1737,254,72
3/4/2021,Selangor,8483,6,284,290,3,298,301,2114,11,40
3/4/2021,Terengganu,1509,0,1,1,0,0,0,8,0,0
3/4/2021,W.P. Labuan,382,0,10,10,0,0,0,39,67,0
4/4/2021,Johor,1658,0,16,16,0,45,45,265,0,0
4/4/2021,Kedah,672,0,8,8,0,5,5,68,1,0
4/4/2021,Kelantan,398,1,36,37,1,49,50,193,3,1
4/4/2021,Melaka,236,0,6,6,0,2,2,50,0,0
4/4/2021,Negeri Sembilan,80,0,0,0,0,0,0,24,0,0
4/4/2021,Pahang,762,6,17,23,2,14,16,98,12,0
4/4/2021,Perak,1069,0,9,9,0,13,13,71,0,188
4/4/2021,Perlis,314,0,0,0,0,0,0,2,0,0
4/4/2021,Pulau Pinang,2031,0,60,60,0,111,111,499,0,0
4/4/2021,Sabah,3410,0,26,26,0,48,48,275,3,0
4/4/2021,Sarawak,4971,19,51,70,3,40,43,1755,311,63
4/4/2021,Selangor,8483,1,722,723,1,404,405,2433,10,40
4/4/2021,Terengganu,1509,0,1,1,0,0,0,9,0,0
4/4/2021,W.P. Labuan,382,1,4,5,7,5,12,38,60,0
5/4/2021,Johor,1658,0,33,33,0,34,34,260,0,0
5/4/2021,Kedah,672,0,11,11,0,7,7,72,1,0
5/4/2021,Kelantan,398,14,20,34,2,59,61,154,15,3
5/4/2021,Melaka,236,0,7,7,0,7,7,50,0,0
5/4/2021,Negeri Sembilan,80,0,0,0,0,0,0,24,0,0
5/4/2021,Pahang,762,0,11,11,3,9,12,100,9,0
5/4/2021,Perak,1069,0,4,4,0,5,5,70,0,199
5/4/2021,Perlis,314,0,2,2,0,0,0,4,0,0
5/4/2021,Pulau Pinang,2031,0,60,60,0,112,112,496,0,0
5/4/2021,Sabah,3410,0,25,25,0,39,39,274,1,0
5/4/2021,Sarawak,5271,9,20,29,2,39,41,1962,373,58
5/4/2021,Selangor,4823,3,179,182,1,385,386,2228,11,40
5/4/2021,Terengganu,1509,1,2,3,0,0,0,11,1,0
5/4/2021,W.P. Labuan,382,2,14,16,5,6,11,35,44,0
6/4/2021,Johor,1658,0,19,19,0,20,20,258,0,0
6/4/2021,Kedah,672,0,18,18,0,15,15,73,1,0
6/4/2021,Kelantan,398,1,13,14,4,20,24,139,20,3
6/4/2021,Melaka,236,0,3,3,0,5,5,47,0,0
6/4/2021,Negeri Sembilan,80,0,0,0,0,3,3,21,0,0
6/4/2021,Pahang,762,2,17,19,1,14,15,103,10,0
6/4/2021,Perak,1069,0,24,24,0,2,2,91,0,178
6/4/2021,Perlis,314,0,0,0,0,0,0,4,0,0
6/4/2021,Pulau Pinang,2031,0,96,96,0,118,118,454,0,0
6/4/2021,Sabah,3410,0,49,49,0,28,28,311,1,0
6/4/2021,Sarawak,5333,10,33,43,2,43,45,2002,375,65
6/4/2021,Selangor,4823,7,339,346,0,275,275,2292,18,40
6/4/2021,Terengganu,1509,0,0,0,0,0,0,11,1,0
6/4/2021,W.P. Labuan,382,0,15,15,2,1,3,56,45,0
7/4/2021,Johor,1660,0,32,32,0,9,9,280,0,0
7/4/2021,Kedah,672,0,16,16,0,5,5,84,1,0
7/4/2021,Kelantan,398,6,42,48,5,21,26,160,21,4
7/4/2021,Melaka,236,0,1,1,0,5,5,45,0,0
7/4/2021,Negeri Sembilan,80,0,0,0,0,9,9,12,0,0
7/4/2021,Pahang,762,1,7,8,0,14,14,96,11,0
7/4/2021,Perak,1069,0,64,64,0,2,2,152,1,172
7/4/2021,Perlis,314,0,0,0,0,0,0,4,0,0
7/4/2021,Pulau Pinang,1851,0,73,73,0,81,81,444,0,0
7/4/2021,Sabah,3100,2,33,35,1,37,38,319,2,0
7/4/2021,Sarawak,5333,23,129,152,9,26,35,2203,413,64
7/4/2021,Selangor,4823,11,289,300,2,204,206,2377,27,40
7/4/2021,Terengganu,1509,0,7,7,0,2,2,16,1,0
7/4/2021,W.P. Labuan,382,0,0,0,1,2,3,59,43,0
8/4/2021,Johor,1060,0,35,35,0,40,40,274,0,0
8/4/2021,Kedah,672,0,7,7,0,14,14,78,0,0
8/4/2021,Kelantan,398,3,30,33,5,28,33,171,19,3
8/4/2021,Melaka,236,0,2,2,0,19,19,26,0,0
8/4/2021,Negeri Sembilan,80,0,0,0,0,0,0,12,0,0
8/4/2021,Pahang,762,0,12,12,0,13,13,95,11,0
8/4/2021,Perak,1069,0,13,13,0,39,39,126,1,178
8/4/2021,Perlis,314,0,0,0,0,0,0,4,0,0
8/4/2021,Pulau Pinang,1851,0,63,63,0,68,68,441,0,0
8/4/2021,Sabah,3242,0,35,35,0,44,44,313,2,0
8/4/2021,Sarawak,5307,8,35,43,3,31,34,2296,366,30
8/4/2021,Selangor,4289,0,273,273,2,388,390,2263,24,40
8/4/2021,Terengganu,1509,0,8,8,0,0,0,24,1,0
8/4/2021,W.P. Labuan,222,2,0,2,1,2,3,55,49,0
9/4/2021,Johor,1660,0,33,33,0,29,29,278,0,0
9/4/2021,Kedah,600,0,7,7,0,5,5,78,2,0
9/4/2021,Kelantan,398,6,28,34,5,19,24,180,20,4
9/4/2021,Melaka,236,0,16,16,0,1,1,41,0,0
9/4/2021,Negeri Sembilan,80,0,36,36,0,6,6,42,0,0
9/4/2021,Pahang,762,0,8,8,2,6,8,104,9,0
9/4/2021,Perak,1069,0,6,6,0,4,4,128,0,179
9/4/2021,Perlis,314,0,0,0,0,1,1,3,0,0
9/4/2021,Pulau Pinang,1851,0,108,108,0,63,63,487,0,0
9/4/2021,Sabah,3242,0,55,55,1,34,35,347,6,0
9/4/2021,Sarawak,5333,2,26,28,15,25,40,2333,334,69
9/4/2021,Selangor,4289,4,384,388,2,410,412,2238,25,40
9/4/2021,Terengganu,1509,0,11,11,0,1,1,34,1,0
9/4/2021,W.P. Labuan,222,4,0,4,0,11,11,46,51,0
10/4/2021,Johor,1660,0,15,15,0,25,25,267,0,0
10/4/2021,Kedah,600,0,7,7,0,12,12,75,0,0
10/4/2021,Kelantan,398,7,73,80,2,19,21,234,25,5
10/4/2021,Melaka,236,0,1,1,0,3,3,39,0,0
10/4/2021,Negeri Sembilan,80,0,0,0,0,0,0,42,0,0
10/4/2021,Pahang,762,0,15,15,2,27,29,92,7,0
10/4/2021,Perak,1069,0,17,17,0,9,9,135,0,153
10/4/2021,Perlis,314,0,0,0,0,0,0,3,0,0
10/4/2021,Pulau Pinang,1851,0,79,79,0,71,71,502,0,0
10/4/2021,Sabah,3242,0,67,67,1,45,46,398,5,0
10/4/2021,Sarawak,5723,12,74,86,7,199,206,2372,304,63
10/4/2021,Selangor,4289,0,324,324,0,749,749,1815,25,40
10/4/2021,Terengganu,1509,0,16,16,0,4,4,46,1,0
10/4/2021,W.P. Labuan,222,0,3,3,11,19,30,31,41,0
11/4/2021,Johor,1660,0,22,22,0,19,19,269,0,0
11/4/2021,Kedah,600,0,16,16,0,11,11,80,0,0
11/4/2021,Kelantan,398,8,89,97,3,18,21,305,30,5
11/4/2021,Melaka,236,0,43,43,0,11,11,71,0,0
11/4/2021,Negeri Sembilan,80,0,0,0,0,0,0,42,0,0
11/4/2021,Pahang,762,2,13,15,4,15,19,90,5,0
11/4/2021,Perak,1069,0,15,15,0,23,23,126,0,168
11/4/2021,Perlis,314,0,0,0,0,0,0,3,0,0
11/4/2021,Pulau Pinang,1851,0,69,69,0,107,107,29,0,443
11/4/2021,Sabah,3242,1,87,88,0,73,73,445,7,0
11/4/2021,Sarawak,5723,9,73,82,3,35,38,2397,291,61
11/4/2021,Selangor,4289,5,310,315,6,309,315,1819,21,40
11/4/2021,Terengganu,1509,0,34,34,0,1,1,79,1,0
11/4/2021,W.P. Labuan,222,5,0,5,12,13,25,19,33,0
12/4/2021,Johor,1660,0,61,61,0,78,78,250,0,0
12/4/2021,Kedah,600,0,12,12,0,11,11,83,0,0
12/4/2021,Kelantan,438,0,48,48,4,20,24,333,26,6
12/4/2021,Melaka,249,0,2,2,0,3,3,70,0,0
12/4/2021,Negeri Sembilan,80,0,1,1,0,0,0,43,0,0
12/4/2021,Pahang,762,1,7,8,0,12,12,85,6,0
12/4/2021,Perak,1069,0,23,23,0,9,9,140,0,170
12/4/2021,Perlis,314,0,1,1,0,0,0,4,0,0
12/4/2021,Pulau Pinang,1851,0,72,72,0,107,107,433,0,0
12/4/2021,Sabah,3242,1,71,72,3,42,45,487,5,0
12/4/2021,Sarawak,5723,6,59,65,0,41,41,2557,279,59
12/4/2021,Selangor,4289,5,205,210,4,328,332,1697,21,40
12/4/2021,Terengganu,1509,2,24,26,0,4,4,99,3,0
12/4/2021,W.P. Labuan,222,1,5,6,5,6,11,18,29,0
13/4/2021,Johor,1660,0,31,31,0,28,28,253,0,0
13/4/2021,Kedah,600,0,10,10,0,8,8,85,0,0
13/4/2021,Kelantan,438,2,38,40,9,19,28,352,19,5
13/4/2021,Melaka,256,0,3,3,0,1,1,72,0,0
13/4/2021,Negeri Sembilan,80,0,0,0,0,0,0,43,0,0
13/4/2021,Pahang,762,1,30,31,0,13,13,101,7,0
13/4/2021,Perak,1069,0,16,16,0,6,6,150,0,173
13/4/2021,Perlis,314,0,0,0,0,0,0,4,0,0
13/4/2021,Pulau Pinang,1851,0,43,43,0,87,87,386,0,0
13/4/2021,Sabah,3242,1,41,42,0,46,46,486,10,0
13/4/2021,Sarawak,5723,7,46,53,5,26,31,2485,309,102
13/4/2021,Selangor,4289,3,599,602,4,279,283,2018,19,40
13/4/2021,Terengganu,1509,1,20,21,1,2,3,117,3,0
13/4/2021,W.P. Labuan,222,1,0,1,7,5,12,11,23,0
14/4/2021,Johor,1660,0,5,5,0,13,13,242,0,0
14/4/2021,Kedah,600,2,1,3,0,22,22,67,2,0
14/4/2021,Kelantan,458,0,51,51,6,28,34,375,13,8
14/4/2021,Melaka,256,0,0,0,0,7,7,65,0,0
14/4/2021,Negeri Sembilan,80,0,0,0,0,5,5,38,0,0
14/4/2021,Pahang,762,4,8,12,3,15,18,94,8,0
14/4/2021,Perak,1069,0,16,16,0,53,53,113,1,183
14/4/2021,Perlis,314,0,0,0,0,0,0,4,0,0
14/4/2021,Pulau Pinang,1851,0,48,48,0,88,88,344,0,0
14/4/2021,Sabah,3242,5,59,64,2,59,61,501,13,0
14/4/2021,Sarawak,5865,9,161,170,4,39,43,2837,342,68
14/4/2021,Selangor,4289,7,399,406,1,166,167,2252,25,40
14/4/2021,Terengganu,1509,2,11,13,0,1,1,127,5,0
14/4/2021,W.P. Labuan,222,0,4,4,2,0,2,11,21,0
15/4/2021,Johor,1660,0,68,68,0,37,37,272,0,0
15/4/2021,Kedah,500,0,28,28,0,4,4,94,0,0
15/4/2021,Kelantan,474,2,90,92,8,68,76,397,6,7
15/4/2021,Melaka,256,0,43,43,0,4,4,104,0,0
15/4/2021,Negeri Sembilan,90,0,46,46,0,0,0,84,0,0
15/4/2021,Pahang,762,3,21,24,0,16,16,99,11,0
15/4/2021,Perak,1069,0,31,31,0,6,6,138,0,178
15/4/2021,Perlis,314,0,0,0,0,1,1,3,0,0
15/4/2021,Pulau Pinang,1851,0,32,32,0,77,77,298,0,0
15/4/2021,Sabah,3342,5,110,115,1,62,63,600,16,0
15/4/2021,Sarawak,5865,14,103,117,2,46,48,3210,368,59
15/4/2021,Selangor,4289,3,443,446,4,365,369,2330,24,40
15/4/2021,Terengganu,1509,1,12,13,0,6,6,133,6,0
15/4/2021,W.P. Labuan,222,3,0,3,4,3,7,9,20,0
16/4/2021,Johor,1660,0,39,39,0,37,37,272,0,0
16/4/2021,Kedah,500,1,8,9,0,19,19,81,1,0
16/4/2021,Kelantan,474,1,82,83,0,31,31,448,8,7
16/4/2021,Melaka,196,0,21,21,0,0,0,25,0,0
16/4/2021,Negeri Sembilan,90,0,1,1,0,0,0,85,0,0
16/4/2021,Pahang,762,2,28,30,0,7,7,118,13,0
16/4/2021,Perak,1069,0,22,22,0,24,24,133,0,167
16/4/2021,Perlis,314,0,0,0,0,2,2,1,0,0
16/4/2021,Pulau Pinang,1851,0,91,91,0,54,54,336,0,0
16/4/2021,Sabah,3456,2,117,119,3,99,102,608,15,0
16/4/2021,Sarawak,5865,11,58,69,1,63,64,3252,400,60
16/4/2021,Selangor,4289,3,363,366,4,354,358,2342,21,40
16/4/2021,Terengganu,1509,1,8,9,6,6,12,135,7,0
16/4/2021,W.P. Labuan,222,6,4,10,4,1,5,12,22,0
17/4/2021,Johor,1660,0,48,48,0,17,17,303,0,0
17/4/2021,Kedah,500,0,16,16,0,6,6,89,3,0
17/4/2021,Kelantan,674,0,69,69,0,38,38,483,6,10
17/4/2021,Melaka,286,0,21,21,0,11,11,113,0,0
17/4/2021,Negeri Sembilan,90,0,0,0,0,25,25,60,0,0
17/4/2021,Pahang,762,0,26,26,0,16,16,130,13,0
17/4/2021,Perak,1069,0,43,43,0,2,2,174,0,173
17/4/2021,Perlis,314,0,0,0,0,0,0,1,0,0
17/4/2021,Pulau Pinang,1851,0,49,49,0,91,91,289,0,0
17/4/2021,Sabah,3492,1,95,96,1,86,87,633,13,0
17/4/2021,Sarawak,5977,7,125,132,9,129,138,3362,474,21
17/4/2021,Selangor,4793,4,425,429,5,357,362,2410,20,40
17/4/2021,Terengganu,1509,0,22,22,0,13,13,144,7,0
17/4/2021,W.P. Labuan,222,2,0,2,1,0,1,12,23,0
18/4/2021,Johor,1660,0,51,51,0,21,21,332,0,0
18/4/2021,Kedah,500,1,13,14,0,5,5,101,3,0
18/4/2021,Kelantan,674,1,117,118,1,71,72,535,6,11
18/4/2021,Melaka,286,0,0,0,0,3,3,109,0,0
18/4/2021,Negeri Sembilan,90,0,0,0,0,0,0,60,0,0
18/4/2021,Pahang,762,1,14,15,0,5,5,139,14,0
18/4/2021,Perak,1069,0,12,12,0,15,15,171,0,173
18/4/2021,Perlis,314,0,0,0,0,0,0,1,0,0
18/4/2021,Pulau Pinang,1851,0,54,54,0,68,68,305,0,0
18/4/2021,Sabah,3492,2,62,64,0,56,56,643,13,0
18/4/2021,Sarawak,5977,12,64,76,1,47,48,3519,533,37
18/4/2021,Selangor,4793,12,365,377,9,489,498,2287,22,40
18/4/2021,Terengganu,1509,1,6,7,2,23,25,127,6,0
18/4/2021,W.P. Labuan,222,0,2,2,4,4,8,10,19,0
19/4/2021,Johor,1660,0,69,69,0,64,64,332,0,0
19/4/2021,Kedah,500,8,21,29,0,18,18,107,11,0
19/4/2021,Kelantan,694,1,172,173,3,91,94,616,4,13
19/4/2021,Melaka,286,0,12,12,0,43,43,78,0,0
19/4/2021,Negeri Sembilan,90,0,0,0,0,0,0,60,0,0
19/4/2021,Pahang,762,0,13,13,4,29,33,153,10,0
19/4/2021,Perak,1069,0,20,20,0,22,22,169,0,179
19/4/2021,Perlis,314,3,0,3,0,0,0,3,5,0
19/4/2021,Pulau Pinang,1851,0,32,32,0,61,61,278,0,0
19/4/2021,Sabah,3492,1,62,63,2,71,73,635,13,0
19/4/2021,Sarawak,6291,1,57,58,3,48,51,3558,516,38
19/4/2021,Selangor,4793,4,349,353,1,513,514,2123,25,40
19/4/2021,Terengganu,1509,3,12,15,0,27,27,112,9,0
19/4/2021,W.P. Labuan,222,0,5,5,0,2,2,13,15,0
20/4/2021,Johor,1660,0,74,74,0,20,20,384,0,0
20/4/2021,Kedah,500,1,5,6,0,10,10,105,13,0
20/4/2021,Kelantan,694,0,70,70,0,37,37,649,4,13
20/4/2021,Melaka,286,0,0,0,0,1,1,77,0,0
20/4/2021,Negeri Sembilan,90,0,0,0,0,12,12,48,0,0
20/4/2021,Pahang,722,0,37,37,2,15,17,145,8,0
20/4/2021,Perak,1069,0,10,10,0,20,20,159,1,189
20/4/2021,Perlis,314,0,3,3,0,0,0,6,2,0
20/4/2021,Pulau Pinang,1851,0,32,32,0,25,25,298,0,0
20/4/2021,Sabah,3394,6,70,76,1,82,83,632,18,0
20/4/2021,Sarawak,6233,8,72,80,4,337,341,3519,469,43
20/4/2021,Selangor,4793,2,460,462,5,365,370,2218,22,40
20/4/2021,Terengganu,1509,0,3,3,1,30,31,85,7,0
20/4/2021,W.P. Labuan,222,0,6,6,3,0,3,19,9,0
21/4/2021,Johor,1660,0,76,76,0,37,37,398,0,0
21/4/2021,Kedah,500,0,15,15,2,7,9,119,3,0
21/4/2021,Kelantan,694,2,61,63,0,90,90,620,6,8
21/4/2021,Melaka,286,0,2,2,0,4,4,75,0,0
21/4/2021,Negeri Sembilan,90,0,3,3,0,0,0,51,0,0
21/4/2021,Pahang,722,0,17,17,3,11,14,151,5,0
21/4/2021,Perak,1069,0,11,11,0,12,12,162,0,194
21/4/2021,Perlis,314,0,0,0,0,1,1,5,2,0
21/4/2021,Pulau Pinang,1851,0,68,68,0,36,36,333,0,0
21/4/2021,Sabah,3394,1,66,67,2,66,68,632,17,0
21/4/2021,Sarawak,6233,1,88,89,2,30,32,3575,486,39
21/4/2021,Selangor,4843,1,623,624,7,247,254,2597,13,40
21/4/2021,Terengganu,1509,0,7,7,2,18,20,74,5,0
21/4/2021,W.P. Labuan,222,1,0,1,0,3,3,17,10,0
22/4/2021,Johor,1660,0,105,105,0,39,39,460,0,0
22/4/2021,Kedah,500,1,21,22,1,28,29,127,2,0
22/4/2021,Kelantan,694,3,112,115,0,113,113,619,9,11
22/4/2021,Melaka,286,0,1,1,0,44,44,32,0,0
22/4/2021,Negeri Sembilan,90,0,0,0,0,0,0,51,0,0
22/4/2021,Pahang,722,0,47,47,3,44,47,154,2,0
22/4/2021,Perak,1069,0,19,19,0,23,23,158,0,178
22/4/2021,Perlis,314,0,0,0,0,0,0,5,2,0
22/4/2021,Pulau Pinang,1851,0,81,81,0,53,53,364,0,0
22/4/2021,Sabah,3394,2,114,116,3,99,102,662,16,0
22/4/2021,Sarawak,6405,2,68,70,5,94,99,3757,495,35
22/4/2021,Selangor,4843,5,548,553,2,650,652,2498,13,40
22/4/2021,Terengganu,1509,0,0,0,3,31,34,42,3,0
22/4/2021,W.P. Labuan,222,4,1,5,2,1,3,17,12,0
23/4/2021,Johor,1665,0,88,88,0,66,66,478,0,0
23/4/2021,Kedah,500,0,43,43,0,14,14,154,0,0
23/4/2021,Kelantan,694,0,107,107,1,84,85,642,8,14
23/4/2021,Melaka,286,2,12,14,0,12,12,32,2,0
23/4/2021,Negeri Sembilan,170,0,56,56,0,10,10,97,0,0
23/4/2021,Pahang,722,1,40,41,1,14,15,180,2,0
23/4/2021,Perak,815,0,22,22,0,26,26,152,0,171
23/4/2021,Perlis,314,0,0,0,0,2,2,4,2,0
23/4/2021,Pulau Pinang,1851,0,40,40,0,81,81,326,0,0
23/4/2021,Sabah,3394,0,93,93,4,100,104,647,10,0
23/4/2021,Sarawak,6405,3,47,50,1,222,223,3420,534,36
23/4/2021,Selangor,4843,4,604,608,3,518,521,2584,14,40
23/4/2021,Terengganu,1509,1,18,19,0,10,10,50,4,0
23/4/2021,W.P. Labuan,222,2,3,5,2,0,2,20,12,0
24/4/2021,Johor,1665,0,59,59,0,12,12,514,0,0
24/4/2021,Kedah,500,0,7,7,0,22,22,140,3,0
24/4/2021,Kelantan,894,0,189,189,3,100,103,724,5,23
24/4/2021,Melaka,286,0,4,4,2,2,4,34,0,0
24/4/2021,Negeri Sembilan,170,0,1,1,0,0,0,98,0,0
24/4/2021,Pahang,722,0,16,16,0,14,14,182,2,0
24/4/2021,Perak,815,0,40,40,0,28,28,163,2,159
24/4/2021,Perlis,314,0,0,0,0,0,0,4,2,0
24/4/2021,Pulau Pinang,1851,0,48,48,0,54,54,323,0,0
24/4/2021,Sabah,3394,5,104,109,1,104,105,661,12,0
24/4/2021,Sarawak,6405,1,74,75,3,141,144,3258,487,35
24/4/2021,Selangor,4843,2,589,591,2,491,493,2683,13,40
24/4/2021,Terengganu,1509,1,6,7,1,3,4,53,4,0
24/4/2021,W.P. Labuan,222,0,2,2,0,2,2,20,10,0
25/4/2021,Johor,1667,0,38,38,0,47,47,505,0,0
25/4/2021,Kedah,500,0,12,12,0,21,21,134,3,0
25/4/2021,Kelantan,890,2,127,129,2,93,95,758,5,16
25/4/2021,Melaka,286,0,2,2,0,1,1,35,0,0
25/4/2021,Negeri Sembilan,190,0,22,22,0,0,0,120,0,0
25/4/2021,Pahang,722,2,28,30,0,37,37,172,4,0
25/4/2021,Perak,815,0,12,12,0,18,18,159,1,167
25/4/2021,Perlis,314,0,0,0,1,0,1,4,1,0
25/4/2021,Pulau Pinang,1261,0,48,48,0,65,65,312,0,0
25/4/2021,Sabah,3394,5,101,106,1,75,76,688,14,0
25/4/2021,Sarawak,6405,7,16,23,1,33,34,3009,522,0
25/4/2021,Selangor,4843,9,576,585,3,489,492,2770,19,40
25/4/2021,Terengganu,1509,1,35,36,0,1,1,87,5,0
25/4/2021,W.P. Labuan,222,0,3,3,1,8,9,17,9,0
26/4/2021,Johor,1667,0,80,80,0,57,57,525,0,0
26/4/2021,Kedah,500,0,37,37,0,7,7,168,3,0
26/4/2021,Kelantan,1068,0,240,240,2,214,216,784,3,14
26/4/2021,Melaka,286,0,2,2,0,16,16,21,0,0
26/4/2021,Negeri Sembilan,190,0,0,0,0,0,0,119,0,0
26/4/2021,Pahang,722,0,20,20,0,10,10,182,4,0
26/4/2021,Perak,815,0,13,13,0,21,21,150,0,170
26/4/2021,Perlis,314,0,0,0,0,0,0,4,1,0
26/4/2021,Pulau Pinang,1261,0,56,56,0,29,29,338,0,0
26/4/2021,Sabah,3394,2,40,42,1,80,81,650,16,0
26/4/2021,Sarawak,6523,2,39,41,8,60,68,3108,496,32
26/4/2021,Selangor,4843,3,509,512,3,524,527,2757,19,40
26/4/2021,Terengganu,1509,7,23,30,1,17,18,93,11,0
26/4/2021,W.P. Labuan,222,0,3,3,1,8,9,17,9,0
27/4/2021,Johor,1673,0,58,58,0,39,39,540,0,0
27/4/2021,Kedah,500,0,13,13,2,5,7,171,1,0
27/4/2021,Kelantan,1068,6,142,148,1,156,157,767,8,13
27/4/2021,Melaka,286,0,1,1,0,6,6,16,0,0
27/4/2021,Negeri Sembilan,190,0,16,16,0,36,36,99,0,0
27/4/2021,Pahang,722,1,22,23,0,16,16,188,5,0
27/4/2021,Perak,815,0,17,17,0,19,19,148,0,181
27/4/2021,Perlis,314,0,0,0,1,0,1,4,0,0
27/4/2021,Pulau Pinang,1261,0,76,76,0,44,44,368,0,0
27/4/2021,Sabah,3394,6,74,80,3,93,96,633,18,0
27/4/2021,Sarawak,6523,4,76,80,2,74,76,3043,517,37
27/4/2021,Selangor,4843,5,558,563,1,480,481,2840,18,40
27/4/2021,Terengganu,1509,0,5,5,3,10,13,88,8,0
27/4/2021,W.P. Labuan,222,9,1,10,1,1,2,11,13,0
28/4/2021,Johor,1719,0,128,128,0,36,36,741,0,0
28/4/2021,Kedah,500,0,21,21,0,13,13,176,0,0
28/4/2021,Kelantan,1068,2,118,120,0,80,80,805,10,9
28/4/2021,Melaka,286,0,6,6,0,2,2,20,0,0
28/4/2021,Negeri Sembilan,190,0,0,0,0,0,0,99,0,0
28/4/2021,Pahang,722,0,26,26,0,21,21,191,5,0
28/4/2021,Perak,815,0,17,17,0,19,19,145,1,170
28/4/2021,Perlis,314,0,0,0,0,4,4,0,0,0
28/4/2021,Pulau Pinang,1261,0,33,33,0,105,105,294,0,0
28/4/2021,Sabah,3394,2,48,50,0,135,135,547,19,0
28/4/2021,Sarawak,6523,1,93,94,1,12,13,3133,526,40
28/4/2021,Selangor,4843,4,750,754,1,440,441,3150,21,40
28/4/2021,Terengganu,1509,4,37,41,0,7,7,118,12,0
28/4/2021,W.P. Labuan,222,3,2,5,0,0,0,13,16,0
29/4/2021,Johor,1757,0,137,137,0,77,77,809,0,0
29/4/2021,Kedah,500,0,56,56,0,54,54,176,0,0
29/4/2021,Kelantan,1068,2,136,138,0,115,115,826,12,5
29/4/2021,Melaka,286,0,4,4,0,6,6,18,0,0
29/4/2021,Negeri Sembilan,190,0,43,43,0,39,39,103,0,0
29/4/2021,Pahang,722,1,40,41,0,62,62,169,6,0
29/4/2021,Perak,815,0,19,19,0,9,9,151,1,180
29/4/2021,Perlis,314,0,0,0,0,0,0,0,0,0
29/4/2021,Pulau Pinang,1261,0,31,31,0,59,59,269,0,0
29/4/2021,Sabah,3394,5,60,65,0,90,90,491,29,0
29/4/2021,Sarawak,6523,3,70,73,5,40,45,3099,501,35
29/4/2021,Selangor,4843,4,806,810,2,584,586,3344,21,40
29/4/2021,Terengganu,1509,4,31,35,0,15,15,134,16,0
29/4/2021,W.P. Labuan,222,0,2,2,0,2,2,13,16,0
30/4/2021,Johor,1767,0,96,96,0,88,88,803,0,0
30/4/2021,Kedah,500,0,47,47,0,23,23,206,0,0
30/4/2021,Kelantan,1068,3,110,113,2,74,76,861,13,4
30/4/2021,Melaka,286,0,4,4,0,7,7,15,0,0
30/4/2021,Negeri Sembilan,190,0,3,3,0,2,2,104,0,0
30/4/2021,Pahang,722,5,48,53,2,38,40,179,9,0
30/4/2021,Perak,853,0,70,70,0,21,21,198,0,177
30/4/2021,Perlis,314,0,0,0,0,0,0,0,0,0
30/4/2021,Pulau Pinang,1261,0,76,76,0,51,51,294,0,0
30/4/2021,Sabah,3394,2,91,93,1,113,114,437,21,0
30/4/2021,Sarawak,6559,1,67,68,2,58,60,3222,488,37
30/4/2021,Selangor,5938,2,669,671,3,697,700,3324,13,40
30/4/2021,Terengganu,1398,3,21,24,5,31,36,124,14,0
30/4/2021,W.P. Labuan,222,0,0,0,1,4,5,9,13,0
1/5/2021,Johor,1767,0,101,101,0,52,52,847,0,0
1/5/2021,Kedah,500,0,83,83,0,10,10,283,1,0
1/5/2021,Kelantan,1076,2,142,144,1,105,106,898,14,3
1/5/2021,Melaka,286,0,6,6,0,5,5,16,0,0
1/5/2021,Negeri Sembilan,190,0,2,2,0,7,7,97,0,0
1/5/2021,Pahang,722,2,48,50,3,47,50,180,8,0
1/5/2021,Perak,853,0,39,39,0,30,30,205,1,162
1/5/2021,Perlis,314,0,0,0,0,0,0,0,0,0
1/5/2021,Pulau Pinang,1261,0,162,162,0,44,44,418,0,0
1/5/2021,Sabah,3394,3,42,45,3,48,51,430,21,0
1/5/2021,Sarawak,6559,10,65,75,3,109,112,3263,469,26
1/5/2021,Selangor,5938,3,702,705,2,816,818,3212,12,40
1/5/2021,Terengganu,1298,0,16,16,3,20,23,120,11,0
1/5/2021,W.P. Labuan,222,3,2,5,1,2,3,9,15,0
2/5/2021,Johor,1768,0,129,129,0,62,62,896,0,0
2/5/2021,Kedah,500,0,64,64,0,32,32,323,1,0
2/5/2021,Kelantan,1076,3,89,92,0,137,137,833,17,3
2/5/2021,Melaka,286,0,7,7,0,9,9,14,0,0
2/5/2021,Negeri Sembilan,190,0,0,0,0,4,4,93,0,0
2/5/2021,Pahang,922,3,39,42,1,14,15,237,10,0
2/5/2021,Perak,853,0,20,20,0,15,15,210,1,166
2/5/2021,Perlis,314,0,0,0,0,0,0,0,0,0
2/5/2021,Pulau Pinang,1261,0,60,60,0,86,86,394,0,0
2/5/2021,Sabah,3394,0,56,56,5,75,80,401,15,0
2/5/2021,Sarawak,6559,1,66,67,1,109,110,3301,528,30
2/5/2021,Selangor,5938,9,846,855,2,671,673,3387,19,40
2/5/2021,Terengganu,1298,1,32,33,0,7,7,145,12,0
2/5/2021,W.P. Labuan,222,0,10,10,1,2,3,17,13,0
3/5/2021,Johor,1772,0,123,123,0,75,75,935,0,0
3/5/2021,Kedah,500,0,28,28,0,41,41,309,1,0
3/5/2021,Kelantan,1076,2,75,77,0,135,135,773,19,4
3/5/2021,Melaka,286,0,9,9,0,5,5,18,0,0
3/5/2021,Negeri Sembilan,190,0,0,0,0,37,37,56,0,0
3/5/2021,Pahang,922,0,44,44,2,30,32,242,8,0
3/5/2021,Perak,845,0,23,23,0,25,25,207,1,182
3/5/2021,Perlis,314,0,0,0,0,0,0,0,0,0
3/5/2021,Pulau Pinang,1261,0,60,60,0,45,45,409,0,0
3/5/2021,Sabah,3394,3,52,55,1,61,62,395,17,0
3/5/2021,Sarawak,6559,4,88,92,8,75,83,3270,513,46
3/5/2021,Selangor,5938,4,527,531,7,691,698,3223,16,40
3/5/2021,Terengganu,1298,0,142,142,1,12,13,275,11,0
3/5/2021,W.P. Labuan,222,0,0,0,0,1,1,16,13,0
4/5/2021,Johor,1772,0,135,135,0,60,60,966,0,0
4/5/2021,Kedah,500,0,57,57,0,34,34,342,1,0
4/5/2021,Kelantan,1652,0,181,181,3,86,89,868,16,7
4/5/2021,Melaka,286,0,6,6,0,3,3,21,0,0
4/5/2021,Negeri Sembilan,190,0,5,5,0,0,0,61,0,0
4/5/2021,Pahang,922,0,21,21,9,25,34,239,8,0
4/5/2021,Perak,845,0,41,41,0,16,16,229,0,163
4/5/2021,Perlis,314,0,0,0,0,0,0,0,0,0
4/5/2021,Pulau Pinang,1261,0,78,78,0,40,40,457,0,0
4/5/2021,Sabah,3394,6,64,70,1,41,42,431,24,0
4/5/2021,Sarawak,6699,4,169,173,3,43,46,3520,507,78
4/5/2021,Selangor,5938,7,662,669,2,561,563,3326,19,40
4/5/2021,Terengganu,1298,0,35,35,1,10,11,298,11,0
4/5/2021,W.P. Labuan,222,7,0,7,0,0,0,16,20,0
5/5/2021,Johor,1772,0,87,87,0,66,66,937,0,0
5/5/2021,Kedah,500,0,39,39,0,58,58,330,1,0
5/5/2021,Kelantan,1652,3,115,118,2,126,128,857,17,7
5/5/2021,Melaka,286,0,13,13,0,5,5,29,0,0
5/5/2021,Negeri Sembilan,190,0,0,0,0,2,2,59,0,0
5/5/2021,Pahang,922,0,26,26,0,10,10,256,8,0
5/5/2021,Perak,845,0,20,20,0,22,22,227,2,206
5/5/2021,Perlis,314,0,0,0,0,0,0,0,0,0
5/5/2021,Pulau Pinang,1261,0,100,100,0,43,43,522,0,0
5/5/2021,Sabah,3394,1,45,46,2,54,56,418,22,0
5/5/2021,Sarawak,6881,8,108,116,10,55,65,3615,500,79
5/5/2021,Selangor,5938,3,648,651,5,491,496,3487,13,40
5/5/2021,Terengganu,1338,0,34,34,2,9,11,323,9,0
5/5/2021,W.P. Labuan,222,0,0,0,0,0,0,16,20,0
6/5/2021,Johor,1772,0,166,166,0,117,117,990,0,0
6/5/2021,Kedah,500,0,76,76,0,70,70,338,1,0
6/5/2021,Kelantan,1652,4,96,100,5,78,83,874,16,7
6/5/2021,Melaka,286,0,4,4,0,5,5,28,0,0
6/5/2021,Negeri Sembilan,190,0,2,2,0,19,19,42,0,0
6/5/2021,Pahang,922,3,52,55,1,40,41,268,10,0
6/5/2021,Perak,845,0,39,39,0,19,19,245,2,176
6/5/2021,Perlis,314,0,0,0,0,0,0,0,0,0
6/5/2021,Pulau Pinang,1261,0,95,95,0,159,159,459,0,0
6/5/2021,Sabah,3394,5,77,82,2,59,61,413,21,0
6/5/2021,Sarawak,6942,8,61,69,3,79,82,3664,600,77
6/5/2021,Selangor,5938,2,789,791,0,743,743,3535,14,40
6/5/2021,Terengganu,1338,2,49,51,7,41,48,331,4,0
6/5/2021,W.P. Labuan,222,0,3,3,6,3,9,23,9,0
7/5/2021,Johor,1772,0,120,120,0,91,91,1011,0,0
7/5/2021,Kedah,500,0,43,43,0,49,49,328,0,0
7/5/2021,Kelantan,1540,0,81,81,2,109,111,777,14,5
7/5/2021,Melaka,286,0,9,9,0,3,3,34,0,0
7/5/2021,Negeri Sembilan,190,0,6,6,0,0,0,48,0,0
7/5/2021,Pahang,922,2,51,53,2,68,70,251,10,0
7/5/2021,Perak,845,0,54,54,0,21,21,277,0,196
7/5/2021,Perlis,314,0,0,0,0,0,0,0,0,0
7/5/2021,Pulau Pinang,1261,0,91,91,0,66,66,492,0,0
7/5/2021,Sabah,3394,1,29,30,5,79,84,352,17,0
7/5/2021,Sarawak,7208,4,87,91,11,70,81,3362,559,74
7/5/2021,Selangor,5938,6,749,755,3,719,722,3566,16,40
7/5/2021,Terengganu,1338,0,47,47,0,28,28,350,4,0
7/5/2021,W.P. Labuan,222,3,3,6,0,6,6,20,12,0
8/5/2021,Johor,2055,0,191,191,0,122,122,1061,0,0
8/5/2021,Kedah,500,0,43,43,0,62,62,303,0,0
8/5/2021,Kelantan,1540,0,84,84,2,143,145,721,12,4
8/5/2021,Melaka,286,0,3,3,0,6,6,31,0,0
8/5/2021,Negeri Sembilan,190,0,0,0,0,5,5,43,0,0
8/5/2021,Pahang,922,7,57,64,3,44,47,269,14,0
8/5/2021,Perak,845,0,32,32,0,70,70,238,0,172
8/5/2021,Perlis,314,0,0,0,0,0,0,0,0,0
8/5/2021,Pulau Pinang,1261,0,184,184,0,64,64,622,0,0
8/5/2021,Sabah,3394,0,38,38,0,53,53,337,16,0
8/5/2021,Sarawak,7208,7,70,77,1,30,31,3431,540,72
8/5/2021,Selangor,6387,5,968,973,2,969,971,3567,17,40
8/5/2021,Terengganu,1338,5,55,60,2,12,14,394,7,0
8/5/2021,W.P. Labuan,222,0,0,0,0,0,0,19,12,0
9/5/2021,Johor,2055,0,123,123,0,127,127,1049,0,0
9/5/2021,Kedah,500,0,71,71,0,68,68,302,0,0
9/5/2021,Kelantan,1540,21,233,254,6,124,130,846,27,5
9/5/2021,Melaka,286,1,1,2,1,15,16,17,0,0
9/5/2021,Negeri Sembilan,190,0,6,6,0,0,0,49,0,0
9/5/2021,Pahang,922,0,45,45,0,35,35,279,0,0
9/5/2021,Perak,845,0,22,22,0,23,23,231,0,175
9/5/2021,Perlis,314,0,0,0,0,0,0,0,0,0
9/5/2021,Pulau Pinang,1261,0,202,202,0,70,70,759,0,0
9/5/2021,Sabah,3394,1,93,94,0,62,62,380,5,0
9/5/2021,Sarawak,6747,9,75,84,39,233,272,3521,531,75
9/5/2021,Selangor,6327,2,942,944,4,690,694,3819,15,40
9/5/2021,Terengganu,1338,9,50,59,0,22,22,422,16,0
9/5/2021,W.P. Labuan,222,0,4,4,0,0,0,23,12,0
10/5/2021,Johor,2055,0,194,194,0,109,109,1127,0,0
10/5/2021,Kedah,500,0,27,27,0,60,60,263,2,0
10/5/2021,Kelantan,1540,6,156,162,6,98,104,904,27,5
10/5/2021,Melaka,286,0,20,20,0,11,11,26,0,0
10/5/2021,Negeri Sembilan,190,0,0,0,0,9,9,40,0,0
10/5/2021,Pahang,922,7,59,66,1,41,42,296,19,0
10/5/2021,Perak,845,0,24,24,0,23,23,231,1,177
10/5/2021,Perlis,314,0,0,0,0,0,0,3,1,0
10/5/2021,Pulau Pinang,1261,0,119,119,0,124,124,757,0,0
10/5/2021,Sabah,3394,1,48,49,1,64,65,359,8,0
10/5/2021,Sarawak,6793,9,51,60,2,79,81,3558,537,66
10/5/2021,Selangor,6283,4,718,722,3,858,861,3661,14,40
10/5/2021,Terengganu,1338,1,47,48,0,158,158,311,17,0
10/5/2021,W.P. Labuan,222,0,2,2,0,7,7,18,11,0
11/5/2021,Johor,2055,0,77,77,0,67,67,1128,0,0
11/5/2021,Kedah,500,0,46,46,0,61,61,248,0,0
11/5/2021,Kelantan,1540,12,137,149,3,91,94,950,37,9
11/5/2021,Melaka,286,1,5,6,0,3,3,29,1,0
11/5/2021,Negeri Sembilan,190,0,0,0,0,13,13,27,0,0
11/5/2021,Pahang,922,2,48,50,2,22,24,322,19,0
11/5/2021,Perak,845,0,28,28,0,27,27,230,3,185
11/5/2021,Perlis,314,0,0,0,0,0,0,2,1,0
11/5/2021,Pulau Pinang,1261,0,119,119,0,125,125,757,0,0
11/5/2021,Sabah,3394,0,44,44,0,63,63,339,6,0
11/5/2021,Sarawak,6919,14,119,133,15,149,164,3582,565,96
11/5/2021,Selangor,6283,5,818,823,3,491,494,3992,12,40
11/5/2021,Terengganu,1338,7,51,58,0,16,16,346,23,0
11/5/2021,W.P. Labuan,222,5,0,5,0,5,5,13,16,0
12/5/2021,Johor,2055,0,209,209,0,90,90,1279,0,0
12/5/2021,Kedah,500,0,55,55,0,46,46,254,2,0
12/5/2021,Kelantan,1900,5,214,219,5,108,113,1056,37,10
12/5/2021,Melaka,286,1,2,3,1,3,4,28,1,0
12/5/2021,Negeri Sembilan,190,0,0,0,0,5,5,22,0,0
12/5/2021,Pahang,922,6,47,53,1,31,32,341,24,0
12/5/2021,Perak,1147,0,84,84,0,26,26,282,2,171
12/5/2021,Perlis,314,0,0,0,0,0,0,2,1,0
12/5/2021,Pulau Pinang,1261,0,110,110,0,95,95,768,0,0
12/5/2021,Sabah,3314,2,42,44,0,36,36,337,10,0
12/5/2021,Sarawak,6919,11,137,148,11,78,89,3474,599,94
12/5/2021,Selangor,6283,4,1001,1005,1,602,603,4394,12,40
12/5/2021,Terengganu,1338,4,76,80,1,41,42,381,26,0
12/5/2021,W.P. Labuan,222,3,6,9,2,2,4,17,17,0
13/5/2021,Johor,2055,0,166,166,0,87,87,1349,0,0
13/5/2021,Kedah,500,0,34,34,0,57,57,225,5,0
13/5/2021,Kelantan,1900,3,174,177,10,109,119,1125,30,11
13/5/2021,Melaka,286,0,6,6,0,8,8,26,0,0
13/5/2021,Negeri Sembilan,190,0,0,0,0,4,4,18,0,0
13/5/2021,Pahang,922,6,50,56,1,27,28,361,23,0
13/5/2021,Perak,1147,0,53,53,0,26,26,308,0,168
13/5/2021,Perlis,314,0,0,0,1,0,1,6,0,0
13/5/2021,Pulau Pinang,1261,0,81,81,0,244,244,612,0,0
13/5/2021,Sabah,3358,0,27,27,1,48,49,235,9,0
13/5/2021,Sarawak,6919,13,133,146,11,87,98,3414,529,153
13/5/2021,Selangor,6283,6,968,974,3,910,913,4453,14,40
13/5/2021,Terengganu,1338,4,94,98,1,42,43,433,29,0
13/5/2021,W.P. Labuan,222,9,4,13,2,5,7,16,24,0
14/5/2021,Johor,2055,0,113,113,0,202,202,1295,0,0
14/5/2021,Kedah,500,0,37,37,0,232,232,214,3,0
14/5/2021,Kelantan,1900,6,153,159,2,129,131,1145,34,7
14/5/2021,Melaka,286,0,9,9,0,2,2,33,0,0
14/5/2021,Negeri Sembilan,190,0,0,0,0,0,0,18,0,0
14/5/2021,Pahang,922,0,34,34,3,58,61,337,26,0
14/5/2021,Perak,1147,0,214,214,0,38,38,482,0,171
14/5/2021,Perlis,314,0,0,0,0,0,0,6,0,0
14/5/2021,Pulau Pinang,1261,0,60,60,0,234,234,442,0,0
14/5/2021,Sabah,3394,5,38,43,3,64,67,293,11,0
14/5/2021,Sarawak,6859,4,87,91,6,155,161,3290,502,138
14/5/2021,Selangor,6283,3,712,715,6,957,963,4210,13,40
14/5/2021,Terengganu,1338,8,112,120,0,55,55,490,37,0
14/5/2021,W.P. Labuan,222,2,4,6,1,1,2,19,25,0
15/5/2021,Johor,2055,0,124,124,0,174,174,1240,0,0
15/5/2021,Kedah,500,0,42,42,0,54,54,202,3,0
15/5/2021,Kelantan,1850,6,123,129,0,65,65,1203,40,10
15/5/2021,Melaka,286,0,6,6,0,4,4,35,0,0
15/5/2021,Negeri Sembilan,190,0,30,30,0,3,3,45,0,0
15/5/2021,Pahang,922,0,47,47,0,15,15,369,26,0
15/5/2021,Perak,1147,0,48,48,0,37,37,488,0,189
15/5/2021,Perlis,314,1,2,3,0,0,0,10,1,0
15/5/2021,Pulau Pinang,1261,0,161,161,0,123,123,495,0,0
15/5/2021,Sabah,3394,10,48,58,2,52,54,288,19,0
15/5/2021,Sarawak,6760,18,113,131,6,35,41,3335,510,124
15/5/2021,Selangor,6283,7,739,746,3,908,911,4041,17,37
15/5/2021,Terengganu,1338,6,83,89,5,50,55,523,38,0
15/5/2021,W.P. Labuan,222,0,5,5,0,0,0,24,23,0
16/5/2021,Johor,2055,0,147,147,0,142,142,1237,0,0
16/5/2021,Kedah,500,0,69,69,0,18,18,254,1,0
16/5/2021,Kelantan,1850,1,78,79,0,111,111,1170,41,11
16/5/2021,Melaka,286,0,5,5,0,14,14,26,0,0
16/5/2021,Negeri Sembilan,190,0,0,0,0,0,0,45,0,0
16/5/2021,Pahang,922,5,77,82,5,50,55,429,35,0
16/5/2021,Perak,1147,0,38,38,0,31,31,493,0,189
16/5/2021,Perlis,314,0,0,0,0,3,3,7,1,0
16/5/2021,Pulau Pinang,1261,0,133,133,0,80,80,556,0,0
16/5/2021,Sabah,3394,5,41,46,1,29,30,298,23,0
16/5/2021,Sarawak,6760,11,39,50,15,68,83,3139,455,147
16/5/2021,Selangor,6283,2,1030,1032,3,907,910,4167,13,40
16/5/2021,Terengganu,1338,11,80,91,5,50,55,553,44,0
16/5/2021,W.P. Labuan,222,5,3,8,0,2,2,25,28,0
17/5/2021,Johor,2055,0,202,202,0,149,149,1270,0,0
17/5/2021,Kedah,500,0,76,76,0,26,26,264,1,0
17/5/2021,Kelantan,1850,3,220,223,23,237,260,1153,21,12
17/5/2021,Melaka,286,0,5,5,0,12,12,19,0,0
17/5/2021,Negeri Sembilan,190,0,0,0,0,5,5,40,0,0
17/5/2021,Pahang,962,8,163,171,5,84,89,528,38,0
17/5/2021,Perak,1147,0,48,48,0,71,71,470,0,206
17/5/2021,Perlis,314,0,0,0,0,1,1,7,1,0
17/5/2021,Pulau Pinang,1261,0,109,109,0,86,86,585,0,0
17/5/2021,Sabah,3394,7,61,68,6,60,66,286,24,0
17/5/2021,Sarawak,6835,7,52,59,15,77,92,3022,438,139
17/5/2021,Selangor,6283,1,683,684,4,1075,1079,3775,10,40
17/5/2021,Terengganu,1338,4,63,67,9,50,59,566,39,0
17/5/2021,W.P. Labuan,222,9,6,15,1,4,5,27,36,0
18/5/2021,Johor,2161,0,169,169,0,173,173,1262,0,0
18/5/2021,Kedah,500,0,60,60,0,50,50,255,1,0
18/5/2021,Kelantan,2006,11,185,196,5,189,194,1149,27,11
18/5/2021,Melaka,286,0,6,6,0,4,4,21,0,0
18/5/2021,Negeri Sembilan,190,0,0,0,0,0,0,40,0,0
18/5/2021,Pahang,962,4,85,89,1,55,56,558,41,0
18/5/2021,Perak,1147,0,44,44,0,46,46,464,3,207
18/5/2021,Perlis,314,5,0,5,1,2,3,5,5,0
18/5/2021,Pulau Pinang,1261,0,60,60,0,76,76,579,0,0
18/5/2021,Sabah,3394,2,45,47,0,64,64,262,21,0
18/5/2021,Sarawak,6835,14,45,59,13,43,56,3103,425,136
18/5/2021,Selangor,6283,2,787,789,4,908,912,3654,8,40
18/5/2021,Terengganu,1338,14,143,157,1,47,48,662,52,0
18/5/2021,W.P. Labuan,222,24,0,24,1,0,1,27,59,0
19/5/2021,Johor,2161,0,169,169,0,168,168,1259,0,0
19/5/2021,Kedah,500,0,50,50,0,59,59,238,2,0
19/5/2021,Kelantan,2006,11,220,231,2,177,179,1192,36,10
19/5/2021,Melaka,286,0,10,10,0,4,4,27,0,0
19/5/2021,Negeri Sembilan,690,0,58,58,0,8,8,89,0,0
19/5/2021,Pahang,1014,6,105,111,2,44,46,619,45,0
19/5/2021,Perak,1147,0,51,51,0,94,94,421,0,215
19/5/2021,Perlis,314,1,3,4,0,1,1,7,6,0
19/5/2021,Pulau Pinang,1261,0,89,89,0,106,106,562,0,0
19/5/2021,Sabah,3394,4,83,87,5,33,38,298,19,0
19/5/2021,Sarawak,6835,11,49,60,6,16,22,3191,460,148
19/5/2021,Selangor,6283,14,1117,1131,7,577,584,4189,10,40
19/5/2021,Terengganu,1358,12,119,131,4,44,48,737,59,0
19/5/2021,W.P. Labuan,222,11,7,18,0,5,5,29,70,0
20/5/2021,Johor,2707,0,148,148,0,210,210,1190,0,0
20/5/2021,Kedah,500,0,52,52,0,52,52,236,0,0
20/5/2021,Kelantan,2006,7,267,274,10,217,227,1242,33,15
20/5/2021,Melaka,286,0,6,6,1,4,5,29,1,0
20/5/2021,Negeri Sembilan,690,0,45,45,0,27,27,104,0,0
20/5/2021,Pahang,1014,5,94,99,8,87,95,633,42,0
20/5/2021,Perak,1201,0,98,98,0,33,33,479,0,189
20/5/2021,Perlis,314,2,0,2,0,0,0,10,7,0
20/5/2021,Pulau Pinang,1261,0,56,56,0,109,109,520,0,0
20/5/2021,Sabah,3470,3,67,70,2,35,37,319,25,0
20/5/2021,Sarawak,6685,8,36,44,4,85,89,3114,436,162
20/5/2021,Selangor,6283,2,836,838,4,835,839,4191,7,40
20/5/2021,Terengganu,1358,7,196,203,8,94,102,839,55,0
20/5/2021,W.P. Labuan,222,3,0,3,3,5,8,37,95,0
21/5/2021,Johor,2707,0,174,174,0,183,183,1179,0,0
21/5/2021,Kedah,500,0,54,54,0,41,41,237,1,0
21/5/2021,Kelantan,2056,7,163,170,1,120,121,1335,39,11
21/5/2021,Melaka,286,3,9,12,0,9,9,29,4,0
21/5/2021,Negeri Sembilan,690,0,90,90,0,4,4,189,0,0
21/5/2021,Pahang,1014,5,121,126,9,105,114,641,38,0
21/5/2021,Perak,1221,0,152,152,0,148,148,478,1,204
21/5/2021,Perlis,314,8,2,10,0,2,2,14,15,0
21/5/2021,Pulau Pinang,1261,0,123,123,0,222,222,430,0,0
21/5/2021,Sabah,3470,19,139,158,4,36,40,407,39,0
21/5/2021,Sarawak,6685,8,44,52,6,92,98,3122,434,161
21/5/2021,Selangor,6283,3,880,883,4,1278,1282,3851,8,40
21/5/2021,Terengganu,1358,16,176,192,2,142,144,879,60,0
21/5/2021,W.P. Labuan,222,7,2,9,1,9,10,42,99,0
22/5/2021,Johor,2406,0,165,165,0,202,202,1133,0,0
22/5/2021,Kedah,500,0,57,57,0,48,48,248,1,0
22/5/2021,Kelantan,2056,7,238,245,3,153,156,1420,43,11
22/5/2021,Melaka,686,0,91,91,1,7,8,114,2,0
22/5/2021,Negeri Sembilan,690,0,180,180,0,7,7,352,0,0
22/5/2021,Pahang,1014,4,101,105,7,112,119,629,35,0
22/5/2021,Perak,1241,0,49,49,0,71,71,452,0,201
22/5/2021,Perlis,314,2,12,14,0,3,3,23,8,0
22/5/2021,Pulau Pinang,1261,0,154,154,0,84,84,509,0,0
22/5/2021,Sabah,2235,8,170,178,0,34,34,515,40,0
22/5/2021,Sarawak,6621,12,69,81,14,82,96,3197,436,179
22/5/2021,Selangor,6627,5,941,946,0,810,810,3982,10,40
22/5/2021,Terengganu,1786,13,184,197,4,78,82,983,77,0
22/5/2021,W.P. Labuan,222,0,29,29,3,8,11,87,63,0
23/5/2021,Johor,2406,0,193,193,0,146,146,1176,0,0
23/5/2021,Kedah,500,0,38,38,0,43,43,232,1,0
23/5/2021,Kelantan,2056,28,250,278,4,156,160,1514,67,2
23/5/2021,Melaka,686,0,129,129,1,8,9,236,1,0
23/5/2021,Negeri Sembilan,690,0,79,79,0,13,13,410,0,0
23/5/2021,Pahang,1014,0,97,97,0,148,148,588,0,0
23/5/2021,Perak,1281,0,75,75,0,22,22,496,0,195
23/5/2021,Perlis,314,0,3,3,0,2,2,27,5,0
23/5/2021,Pulau Pinang,1261,0,162,162,0,53,53,625,0,0
23/5/2021,Sabah,2085,4,136,140,2,37,39,609,42,0
23/5/2021,Sarawak,6671,9,168,177,10,28,38,3366,455,149
23/5/2021,Selangor,6627,1,1267,1268,4,472,476,4777,6,40
23/5/2021,Terengganu,1786,12,139,151,11,90,101,1033,78,0
23/5/2021,W.P. Labuan,222,0,26,26,6,4,10,90,48,0
24/5/2021,Johor,2406,0,154,154,0,99,99,1227,0,0
24/5/2021,Kedah,500,0,54,54,0,51,51,227,0,0
24/5/2021,Kelantan,2056,1,191,192,5,82,87,1623,63,2
24/5/2021,Melaka,686,1,130,131,1,8,9,360,2,0
24/5/2021,Negeri Sembilan,690,0,110,110,0,8,8,508,0,0
24/5/2021,Pahang,1114,3,208,211,10,62,72,733,35,0
24/5/2021,Perak,1091,0,52,52,0,18,18,526,0,193
24/5/2021,Perlis,314,1,2,3,0,1,1,28,6,0
24/5/2021,Pulau Pinang,1261,0,213,213,0,59,59,773,0,0
24/5/2021,Sabah,1471,9,119,128,2,62,64,656,47,0
24/5/2021,Sarawak,6671,6,85,91,8,30,38,3441,445,256
24/5/2021,Selangor,6707,6,721,727,3,667,670,4832,8,40
24/5/2021,Terengganu,1786,11,234,245,7,85,92,1179,81,0
24/5/2021,W.P. Labuan,222,0,0,0,10,10,20,55,36,0
25/5/2021,Johor,2406,0,149,149,0,114,114,1261,0,0
25/5/2021,Kedah,500,0,67,67,0,33,33,250,0,0
25/5/2021,Kelantan,2056,5,198,203,15,232,247,1586,53,2
25/5/2021,Melaka,786,1,127,128,2,12,14,473,1,0
25/5/2021,Negeri Sembilan,690,0,100,100,0,35,35,565,0,0
25/5/2021,Pahang,1114,7,160,167,14,77,91,791,28,0
25/5/2021,Perak,886,0,54,54,0,50,50,526,2,195
25/5/2021,Perlis,314,1,4,5,2,0,2,31,1,0
25/5/2021,Pulau Pinang,1261,0,144,144,0,99,99,831,0,0
25/5/2021,Sabah,1471,4,154,158,1,51,52,756,61,0
25/5/2021,Sarawak,6711,26,76,102,12,62,74,3593,460,157
25/5/2021,Selangor,6707,4,717,721,0,799,799,4429,333,40
25/5/2021,Terengganu,1786,9,186,195,10,96,106,1267,82,0
25/5/2021,W.P. Labuan,222,0,9,9,0,0,0,71,22,0
26/5/2021,Johor,2406,0,163,163,0,183,183,1234,0,0
26/5/2021,Kedah,500,0,52,52,0,54,54,241,0,0
26/5/2021,Kelantan,2056,7,172,179,3,182,185,1576,57,2
26/5/2021,Melaka,1286,0,164,164,0,24,24,609,1,0
26/5/2021,Negeri Sembilan,1090,0,125,125,0,35,35,648,0,0
26/5/2021,Pahang,1114,22,183,205,0,46,46,968,50,0
26/5/2021,Perak,886,0,67,67,0,59,59,527,3,220
26/5/2021,Perlis,314,1,0,1,0,1,1,30,2,0
26/5/2021,Pulau Pinang,1261,0,128,128,0,89,89,855,0,0
26/5/2021,Sabah,1521,5,197,202,7,69,76,871,46,0
26/5/2021,Sarawak,6751,17,72,89,10,45,55,3594,447,144
26/5/2021,Selangor,6260,4,980,984,4,629,633,5104,9,40
26/5/2021,Terengganu,1786,8,186,194,18,224,242,1226,75,0
26/5/2021,W.P. Labuan,222,0,0,0,0,7,7,67,17,0
27/5/2021,Johor,2406,0,143,143,0,164,164,1223,0,0
27/5/2021,Kedah,500,0,35,35,0,52,52,225,0,0
27/5/2021,Kelantan,2056,12,260,272,6,219,225,1615,59,2
27/5/2021,Melaka,1286,0,122,122,0,63,63,653,1,1
27/5/2021,Negeri Sembilan,1090,0,157,157,0,65,65,735,0,0
27/5/2021,Pahang,1114,17,194,211,3,130,133,1010,60,0
27/5/2021,Perak,886,0,58,58,0,66,66,523,3,191
27/5/2021,Perlis,314,1,2,3,0,2,2,30,2,0
27/5/2021,Pulau Pinang,1261,0,118,118,0,132,132,827,0,0
27/5/2021,Sabah,1550,12,151,163,10,132,142,877,47,0
27/5/2021,Sarawak,6751,12,81,93,26,69,95,3712,423,129
27/5/2021,Selangor,6260,0,605,605,0,1182,1182,4528,7,40
27/5/2021,Terengganu,1786,4,159,163,12,205,217,1180,78,0
27/5/2021,W.P. Labuan,222,22,0,22,0,1,1,67,39,0
28/5/2021,Johor,1860,0,220,220,0,196,196,1244,0,0
28/5/2021,Kedah,500,0,53,53,0,47,47,232,0,0
28/5/2021,Kelantan,2256,15,402,417,9,285,294,1727,65,2
28/5/2021,Melaka,1286,0,136,136,0,89,89,700,1,0
28/5/2021,Negeri Sembilan,1690,0,169,169,0,77,77,823,0,0
28/5/2021,Pahang,1114,9,129,138,5,119,124,989,69,0
28/5/2021,Perak,894,0,58,58,0,91,91,486,0,181
28/5/2021,Perlis,314,1,1,2,0,2,2,32,2,0
28/5/2021,Pulau Pinang,1261,0,162,162,0,132,132,874,0,0
28/5/2021,Sabah,1897,8,154,162,4,101,105,922,55,0
28/5/2021,Sarawak,6923,9,111,120,15,70,85,3713,410,149
28/5/2021,Selangor,6260,9,684,693,3,1088,1091,4129,8,40
28/5/2021,Terengganu,2178,14,222,236,9,194,203,1358,81,0
28/5/2021,W.P. Labuan,222,1,0,1,0,3,3,77,43,0
29/5/2021,Johor,1860,0,130,130,0,172,172,1202,0,0
29/5/2021,Kedah,500,0,56,56,0,64,64,217,0,0
29/5/2021,Kelantan,2256,29,478,507,6,274,280,1932,88,2
29/5/2021,Melaka,1286,0,178,178,0,130,130,748,1,0
29/5/2021,Negeri Sembilan,1690,0,156,156,0,158,158,812,0,0
29/5/2021,Pahang,1314,7,206,213,9,152,161,1067,67,0
29/5/2021,Perak,894,0,81,81,0,91,91,471,1,181
29/5/2021,Perlis,314,1,6,7,0,4,4,34,2,0
29/5/2021,Pulau Pinang,1457,0,137,137,0,243,243,775,0,0
29/5/2021,Sabah,1897,8,186,194,11,112,123,989,49,0
29/5/2021,Sarawak,6923,8,73,81,6,74,80,3649,434,152
29/5/2021,Selangor,6270,1,667,668,0,1180,1180,3618,7,40
29/5/2021,Terengganu,2178,25,231,256,12,233,245,1356,93,0
29/5/2021,W.P. Labuan,222,7,0,7,0,10,10,76,54,0
30/5/2021,Johor,1860,0,147,147,0,189,189,1186,0,0
30/5/2021,Kedah,500,0,41,41,0,48,48,206,0,0
30/5/2021,Kelantan,2256,11,325,336,10,269,279,1988,89,0
30/5/2021,Melaka,1286,0,233,233,1,93,94,888,0,0
30/5/2021,Negeri Sembilan,1690,0,217,217,0,144,144,878,0,0
30/5/2021,Pahang,1478,11,381,392,7,209,216,1048,71,0
30/5/2021,Perak,894,0,75,75,0,82,82,458,0,179
30/5/2021,Perlis,314,2,1,3,0,12,12,25,2,0
30/5/2021,Pulau Pinang,1457,0,100,100,0,243,243,756,0,0
30/5/2021,Sabah,1897,5,156,161,2,128,130,1020,46,0
30/5/2021,Sarawak,6979,8,69,77,9,169,178,3609,374,144
30/5/2021,Selangor,6270,0,854,854,0,952,952,3520,7,40
30/5/2021,Terengganu,2178,8,145,153,14,185,199,1313,90,0
30/5/2021,W.P. Labuan,222,9,11,20,1,0,1,61,52,0
31/5/2021,Johor,1860,0,271,271,0,18,18,1241,0,0
31/5/2021,Kedah,500,0,54,54,0,58,58,197,0,0
31/5/2021,Kelantan,2534,8,235,243,9,236,245,1987,88,1
31/5/2021,Melaka,1286,0,145,145,0,175,175,858,0,0
31/5/2021,Negeri Sembilan,1690,0,165,165,0,171,171,865,0,0
31/5/2021,Pahang,1528,14,156,170,3,167,170,945,67,0
31/5/2021,Perak,894,0,53,53,0,54,54,470,0,170
31/5/2021,Perlis,314,1,2,3,0,6,6,21,2,0
31/5/2021,Pulau Pinang,1457,0,120,120,0,140,140,676,0,0
31/5/2021,Sabah,1897,16,156,172,13,158,171,1010,46,0
31/5/2021,Sarawak,7307,19,72,91,5,63,68,3519,390,141
31/5/2021,Selangor,6270,2,572,574,0,850,850,3246,5,40
31/5/2021,Terengganu,2662,27,228,255,13,258,271,1283,102,0
31/5/2021,W.P. Labuan,222,9,1,10,5,1,6,58,58,0
1/6/2021,Johor,1860,0,163,163,0,191,191,1208,0,0
1/6/2021,Kedah,500,0,88,88,0,43,43,258,0,0
1/6/2021,Kelantan,2534,9,228,237,10,248,258,1967,87,1
1/6/2021,Melaka,1286,0,144,144,0,121,121,881,0,0
1/6/2021,Negeri Sembilan,1690,0,210,210,0,159,159,897,0,0
1/6/2021,Pahang,1528,8,119,127,7,140,147,946,64,0
1/6/2021,Perak,894,0,70,70,0,59,59,474,0,187
1/6/2021,Perlis,314,0,1,1,0,1,1,21,1,0
1/6/2021,Pulau Pinang,1457,0,106,106,0,146,146,639,0,0
1/6/2021,Sabah,1978,1,167,168,5,151,156,1029,31,0
1/6/2021,Sarawak,7157,0,29,29,0,26,26,3535,371,0
1/6/2021,Selangor,6270,4,496,500,3,797,800,2946,5,40
1/6/2021,Terengganu,2662,20,159,179,24,183,207,1258,99,0
1/6/2021,W.P. Labuan,273,1,34,35,0,2,2,99,44,0
2/6/2021,Johor,1860,0,184,184,0,190,190,1199,0,0
2/6/2021,Kedah,500,0,43,43,0,55,55,249,0,0
2/6/2021,Kelantan,2497,9,272,281,14,260,274,1979,82,1
2/6/2021,Melaka,1286,0,147,147,0,147,147,879,0,0
2/6/2021,Negeri Sembilan,1690,0,167,167,0,164,164,891,0,0
2/6/2021,Pahang,2908,7,216,223,20,142,162,1021,51,0
2/6/2021,Perak,907,0,130,130,0,63,63,527,0,187
2/6/2021,Perlis,314,1,0,1,0,4,4,16,2,0
2/6/2021,Pulau Pinang,1457,0,206,206,0,160,160,692,0,0
2/6/2021,Sabah,1978,11,208,219,2,122,124,1109,47,0
2/6/2021,Sarawak,7277,0,21,21,0,19,19,3550,379,0
2/6/2021,Selangor,6270,3,865,868,1,567,568,3245,6,40
2/6/2021,Terengganu,2662,24,199,223,7,214,221,1239,119,0
2/6/2021,W.P. Labuan,273,0,1,1,0,0,0,102,34,0
3/6/2021,Johor,1860,0,156,156,0,203,203,1144,0,0
3/6/2021,Kedah,500,0,33,33,0,39,39,246,0,0
3/6/2021,Kelantan,2497,11,260,271,11,289,300,1950,82,1
3/6/2021,Melaka,1776,0,118,118,0,261,261,713,0,0
3/6/2021,Negeri Sembilan,1690,0,195,195,0,139,139,942,0,0
3/6/2021,Pahang,2908,9,131,140,5,169,174,983,57,0
3/6/2021,Perak,907,0,119,119,0,41,41,596,0,177
3/6/2021,Perlis,314,0,1,1,0,3,3,14,1,0
3/6/2021,Pulau Pinang,1457,0,93,93,0,145,145,603,0,0
3/6/2021,Sabah,2118,15,223,238,7,120,127,1207,52,0
3/6/2021,Sarawak,7277,2,77,79,0,46,46,3635,334,0
3/6/2021,Selangor,6270,5,789,794,2,722,724,3272,9,40
3/6/2021,Terengganu,2662,21,182,203,5,235,240,1182,136,0
3/6/2021,W.P. Labuan,273,18,3,21,2,1,3,110,50,0
4/6/2021,Johor,1860,0,214,214,0,139,139,1217,0,0
4/6/2021,Kedah,500,0,54,54,0,35,35,264,0,0
4/6/2021,Kelantan,2497,13,240,253,13,306,319,1883,82,1
4/6/2021,Melaka,1776,0,156,156,0,164,164,705,0,0
4/6/2021,Negeri Sembilan,1690,0,287,287,0,153,153,1073,0,0
4/6/2021,Pahang,2908,6,52,58,9,239,248,794,54,0
4/6/2021,Perak,947,0,112,112,0,49,49,653,3,179
4/6/2021,Perlis,314,0,0,0,1,0,1,16,0,0
4/6/2021,Pulau Pinang,1457,0,232,232,0,195,195,699,0,0
4/6/2021,Sabah,2225,8,127,135,2,174,176,1131,53,0
4/6/2021,Sarawak,7277,0,44,44,0,57,57,3475,330,0
4/6/2021,Selangor,6270,2,755,757,3,688,691,3380,8,40
4/6/2021,Terengganu,2662,16,123,139,13,142,155,1163,135,0
4/6/2021,W.P. Labuan,240,0,0,0,0,5,5,104,45,0
5/6/2021,Johor,1874,0,162,162,0,191,191,1183,0,0
5/6/2021,Kedah,500,0,46,46,0,37,37,269,0,0
5/6/2021,Kelantan,2574,6,173,179,10,244,254,1811,78,1
5/6/2021,Melaka,1776,1,101,102,0,140,140,673,0,0
5/6/2021,Negeri Sembilan,1690,0,118,118,0,199,199,985,0,0
5/6/2021,Pahang,2908,7,200,207,15,131,146,881,46,0
5/6/2021,Perak,947,0,112,112,0,56,56,699,0,172
5/6/2021,Perlis,314,1,0,1,0,4,4,12,1,0
5/6/2021,Pulau Pinang,1457,0,157,157,0,211,211,748,0,0
5/6/2021,Sabah,2225,9,196,205,5,171,176,1139,55,0
5/6/2021,Sarawak,7277,0,35,35,0,38,38,3499,343,0
5/6/2021,Selangor,5328,5,723,728,1,652,653,3437,11,40
5/6/2021,Terengganu,2662,21,199,220,26,226,252,1133,131,0
5/6/2021,W.P. Labuan,240,0,4,4,0,9,9,103,38,0
6/6/2021,Johor,1874,0,152,152,0,177,177,1156,0,0
6/6/2021,Kedah,500,0,48,48,0,66,66,246,0,0
6/6/2021,Kelantan,2546,6,151,157,10,228,238,1733,74,1
6/6/2021,Melaka,1778,0,100,100,1,157,158,616,0,0
6/6/2021,Negeri Sembilan,1848,0,174,174,0,136,136,1019,0,0
6/6/2021,Pahang,2908,3,97,100,7,133,140,847,42,0
6/6/2021,Perak,947,0,59,59,0,113,113,630,1,192
6/6/2021,Perlis,314,1,2,3,0,5,5,13,1,0
6/6/2021,Pulau Pinang,1457,0,202,202,0,164,164,792,0,0
6/6/2021,Sabah,2196,18,189,207,6,209,215,1102,59,0
6/6/2021,Sarawak,7277,0,66,66,1,60,61,3620,359,0
6/6/2021,Selangor,5328,3,716,719,1,659,660,3495,10,40
6/6/2021,Terengganu,2662,26,187,213,18,164,182,1157,140,0
6/6/2021,W.P. Labuan,240,0,23,23,0,0,0,121,18,0
7/6/2021,Johor,1874,0,157,157,0,211,211,1096,0,0
7/6/2021,Kedah,500,0,48,48,0,51,51,244,0,0
7/6/2021,Kelantan,2546,4,154,158,8,311,319,1575,70,1
7/6/2021,Melaka,1778,0,104,104,0,192,192,528,0,0
7/6/2021,Negeri Sembilan,1848,0,156,156,0,214,214,957,0,0
7/6/2021,Pahang,2908,4,106,110,10,147,157,770,36,0
7/6/2021,Perak,947,0,40,40,0,59,59,630,0,192
7/6/2021,Perlis,314,0,1,1,0,0,0,14,0,0
7/6/2021,Pulau Pinang,1457,0,196,196,0,175,175,814,0,0
7/6/2021,Sabah,2225,9,190,199,14,210,224,1078,53,0
7/6/2021,Sarawak,7277,1,71,72,2,71,73,3587,368,0
7/6/2021,Selangor,5328,3,341,344,4,705,709,3132,8,40
7/6/2021,Terengganu,2662,15,110,125,23,216,239,1050,132,0
7/6/2021,W.P. Labuan,539,2,3,5,0,9,9,123,35,0
8/6/2021,Johor,1874,0,133,133,0,156,156,1070,0,0
8/6/2021,Kedah,500,0,48,48,0,63,63,240,0,0
8/6/2021,Kelantan,2546,6,197,203,9,187,196,1584,67,1
8/6/2021,Melaka,1778,1,106,107,0,99,99,535,1,0
8/6/2021,Negeri Sembilan,1848,0,160,160,0,168,168,945,0,0
8/6/2021,Pahang,2908,1,57,58,10,197,207,643,26,0
8/6/2021,Perak,1047,0,190,190,0,67,67,752,0,198
8/6/2021,Perlis,314,0,0,0,0,0,0,14,0,0
8/6/2021,Pulau Pinang,1457,0,109,109,0,109,109,813,0,0
8/6/2021,Sabah,2240,6,217,223,6,140,146,1160,49,0
8/6/2021,Sarawak,7457,0,36,36,0,50,50,3703,417,0
8/6/2021,Selangor,5328,5,585,590,1,708,709,3001,11,40
8/6/2021,Terengganu,2662,3,108,111,31,203,234,954,107,0
8/6/2021,W.P. Labuan,539,1,4,5,2,25,27,161,23,0
9/6/2021,Johor,817,0,50,50,0,48,48,293,0,0
9/6/2021,Kedah,500,0,48,48,0,58,58,234,0,0
9/6/2021,Kelantan,2730,6,145,151,3,223,226,1505,70,1
9/6/2021,Melaka,1778,0,112,112,0,67,67,579,1,1
9/6/2021,Negeri Sembilan,2248,0,233,233,0,156,156,954,0,0
9/6/2021,Pahang,2908,6,196,202,7,97,104,744,25,0
9/6/2021,Perak,1047,0,41,41,0,88,88,699,0,165
9/6/2021,Perlis,314,1,1,2,0,0,0,12,1,0
9/6/2021,Pulau Pinang,1457,0,98,98,0,103,103,803,0,0
9/6/2021,Sabah,2290,9,177,186,5,139,144,1243,45,0
9/6/2021,Sarawak,7457,0,59,59,1,81,82,3720,404,87
9/6/2021,Selangor,5328,0,576,576,4,475,479,3084,5,40
9/6/2021,Terengganu,2662,7,100,107,14,101,115,848,97,0
9/6/2021,W.P. Labuan,539,6,0,6,0,10,10,144,39,0
10/6/2021,Johor,1874,0,141,141,0,124,124,1107,0,0
10/6/2021,Kedah,540,0,31,31,0,51,51,214,0,0
10/6/2021,Kelantan,2730,14,132,146,5,247,252,1390,79,1
10/6/2021,Melaka,1778,0,102,102,1,120,121,561,0,0
10/6/2021,Negeri Sembilan,2248,0,164,164,0,96,96,1007,0,0
10/6/2021,Pahang,2908,8,89,97,6,116,122,717,26,0
10/6/2021,Perak,1047,0,49,49,0,75,75,668,1,193
10/6/2021,Perlis,314,0,1,1,1,1,2,11,0,0
10/6/2021,Pulau Pinang,1457,0,109,109,0,160,160,751,0,0
10/6/2021,Sabah,2349,7,202,209,5,157,162,1266,42,0
10/6/2021,Sarawak,7275,1,82,83,2,65,67,3617,381,0
10/6/2021,Selangor,5328,3,688,691,3,578,581,3194,5,40
10/6/2021,Terengganu,2662,24,60,84,12,140,152,768,106,0
10/6/2021,W.P. Labuan,539,7,14,21,0,18,18,133,39,0
11/6/2021,Johor,1874,0,144,144,0,184,184,1067,0,0
11/6/2021,Kedah,540,0,49,49,0,63,63,199,0,0
11/6/2021,Kelantan,2730,9,177,186,8,223,231,1344,80,0
11/6/2021,Melaka,1778,1,91,92,0,84,84,568,1,0
11/6/2021,Negeri Sembilan,2248,0,173,173,0,147,147,1025,0,0
11/6/2021,Pahang,2908,5,91,96,2,114,116,694,29,0
11/6/2021,Perak,1047,0,47,47,0,118,118,592,3,179
11/6/2021,Perlis,314,0,0,0,0,5,5,7,0,0
11/6/2021,Pulau Pinang,1457,0,138,138,0,192,192,695,0,0
11/6/2021,Sabah,2349,10,211,221,2,139,141,1320,42,0
11/6/2021,Sarawak,7285,0,59,59,1,49,50,3526,401,0
11/6/2021,Selangor,5328,7,590,597,0,636,636,3148,12,40
11/6/2021,Terengganu,2662,20,84,104,13,175,188,676,111,0
11/6/2021,W.P. Labuan,539,9,0,9,0,0,0,132,29,0
12/6/2021,Johor,1874,0,124,124,0,152,152,1035,0,0
12/6/2021,Kedah,540,0,35,35,0,35,35,197,0,0
12/6/2021,Kelantan,2730,10,173,183,10,197,207,1320,80,0
12/6/2021,Melaka,1778,1,103,104,0,84,84,585,1,0
12/6/2021,Negeri Sembilan,2248,0,165,165,0,242,242,939,0,0
12/6/2021,Pahang,2908,3,38,41,7,113,120,590,25,0
12/6/2021,Perak,1047,0,45,45,0,106,106,528,0,161
12/6/2021,Perlis,314,0,1,1,0,2,2,6,0,0
12/6/2021,Pulau Pinang,1457,0,54,54,0,193,193,558,0,0
12/6/2021,Sabah,2349,8,227,235,10,181,191,1341,41,0
12/6/2021,Sarawak,7435,0,109,109,0,56,56,3809,409,75
12/6/2021,Selangor,5328,1,689,690,2,703,705,3138,7,40
12/6/2021,Terengganu,2662,11,61,72,40,123,163,614,81,0
12/6/2021,W.P. Labuan,539,5,1,6,0,2,2,134,26,0
13/6/2021,Johor,1874,0,130,130,0,131,131,1031,0,0
13/6/2021,Kedah,540,0,32,32,0,46,46,201,0,0
13/6/2021,Kelantan,2730,7,192,199,7,195,202,1318,80,0
13/6/2021,Melaka,1778,0,109,109,1,118,119,574,0,0
13/6/2021,Negeri Sembilan,2248,0,167,167,0,171,171,911,0,0
13/6/2021,Pahang,2908,6,89,95,6,90,96,589,25,0
13/6/2021,Perak,1047,0,38,38,0,71,71,490,0,176
13/6/2021,Perlis,314,0,0,0,0,0,0,8,0,0
13/6/2021,Pulau Pinang,1457,0,83,83,0,134,134,525,0,0
13/6/2021,Sabah,2349,9,303,312,9,242,251,1385,45,0
13/6/2021,Sarawak,7609,0,57,57,0,97,97,3657,468,70
13/6/2021,Selangor,5328,0,712,712,3,620,623,3230,4,40
13/6/2021,Terengganu,2662,12,55,67,27,151,178,518,67,0
13/6/2021,W.P. Labuan,539,0,2,2,1,0,1,113,22,0
14/6/2021,Johor,2084,0,152,152,0,177,177,1020,0,0
14/6/2021,Kedah,540,0,95,95,0,30,30,261,1,0
14/6/2021,Kelantan,2730,7,118,125,10,156,166,1280,77,0
14/6/2021,Melaka,1778,0,86,86,0,126,126,534,0,0
14/6/2021,Negeri Sembilan,2248,0,115,115,0,216,216,794,0,0
14/6/2021,Pahang,2908,1,50,51,3,82,85,567,24,0
14/6/2021,Perak,1047,0,63,63,0,73,73,477,0,195
14/6/2021,Perlis,314,0,2,2,0,2,2,8,0,0
14/6/2021,Pulau Pinang,1457,0,172,172,0,101,101,572,0,0
14/6/2021,Sabah,2247,5,222,227,0,220,220,1316,34,0
14/6/2021,Sarawak,7609,5,37,42,2,37,39,3619,452,0
14/6/2021,Selangor,5328,1,536,537,0,589,589,3178,5,40
14/6/2021,Terengganu,2662,2,27,29,15,123,138,421,59,0
14/6/2021,W.P. Labuan,807,11,0,11,0,0,0,154,109,0
15/6/2021,Johor,2084,0,106,106,0,180,180,953,0,0
15/6/2021,Kedah,540,0,53,53,0,31,31,276,0,0
15/6/2021,Kelantan,2730,9,128,137,8,141,149,1267,78,0
15/6/2021,Melaka,1778,0,62,62,0,81,81,515,0,0
15/6/2021,Negeri Sembilan,2345,0,120,120,0,152,152,756,0,0
15/6/2021,Pahang,2908,2,44,46,3,158,161,451,23,0
15/6/2021,Perak,1007,0,58,58,0,118,118,412,0,161
15/6/2021,Perlis,314,0,0,0,0,1,1,7,0,0
15/6/2021,Pulau Pinang,1457,0,138,138,0,104,104,610,0,0
15/6/2021,Sabah,2467,7,207,214,5,188,193,1389,45,0
15/6/2021,Sarawak,7620,10,56,66,0,33,33,3592,441,0
15/6/2021,Selangor,5328,4,660,664,1,486,487,3352,8,40
15/6/2021,Terengganu,2662,18,75,93,15,89,104,407,62,0
15/6/2021,W.P. Labuan,807,0,7,7,0,0,0,166,108,0
16/6/2021,Johor,2084,0,146,146,0,77,77,1019,0,0
16/6/2021,Kedah,540,0,64,64,0,42,42,306,0,0
16/6/2021,Kelantan,2730,14,150,164,16,205,221,1215,76,0
16/6/2021,Melaka,1778,0,93,93,0,100,100,508,0,0
16/6/2021,Negeri Sembilan,2345,0,174,174,0,146,146,774,0,0
16/6/2021,Pahang,2908,0,17,17,15,105,120,363,18,0
16/6/2021,Perak,1007,0,19,19,0,84,84,344,0,160
16/6/2021,Perlis,314,0,2,2,0,3,3,5,0,0
16/6/2021,Pulau Pinang,1877,0,110,110,0,49,49,641,0,0
16/6/2021,Sabah,2509,9,263,272,8,179,187,1462,47,0
16/6/2021,Sarawak,8081,0,78,78,0,81,81,3621,887,0
16/6/2021,Selangor,5328,2,881,883,0,425,425,3810,8,40
16/6/2021,Terengganu,2662,14,36,50,18,90,108,353,58,0
16/6/2021,W.P. Labuan,649,4,6,10,4,0,4,210,60,0
17/6/2021,Johor,2084,0,209,209,0,169,169,1057,0,0
17/6/2021,Kedah,540,0,37,37,0,37,37,306,0,0
17/6/2021,Kelantan,2730,7,106,113,11,196,207,1135,72,0
17/6/2021,Melaka,1778,0,86,86,0,58,58,536,0,0
17/6/2021,Negeri Sembilan,2345,0,229,229,0,72,72,909,0,0
17/6/2021,Pahang,2908,1,35,36,6,84,90,314,13,0
17/6/2021,Perak,1007,0,11,11,0,21,21,330,0,160
17/6/2021,Perlis,314,0,0,0,0,0,0,5,0,0
17/6/2021,Pulau Pinang,1877,0,49,49,0,80,80,609,0,0
17/6/2021,Sabah,2744,8,145,153,8,257,265,1307,41,0
17/6/2021,Sarawak,7901,34,99,133,1,40,41,3796,880,0
17/6/2021,Selangor,5328,7,806,813,1,517,518,4099,14,40
17/6/2021,Terengganu,2662,8,44,52,21,82,103,315,44,0
17/6/2021,W.P. Labuan,649,0,17,17,0,0,0,229,59,0
18/6/2021,Johor,2084,0,237,237,0,149,149,1142,0,0
18/6/2021,Kedah,540,0,65,65,0,36,36,329,0,0
18/6/2021,Kelantan,2716,5,97,102,5,142,147,1088,72,0
18/6/2021,Melaka,1778,0,69,69,0,121,121,477,0,0
18/6/2021,Negeri Sembilan,2345,0,200,200,0,125,125,966,0,0
18/6/2021,Pahang,2908,0,261,261,2,70,72,289,11,52
18/6/2021,Perak,1007,0,109,109,0,47,47,389,0,158
18/6/2021,Perlis,314,0,0,0,0,0,0,5,0,0
18/6/2021,Pulau Pinang,1877,0,45,45,0,113,113,546,0,0
18/6/2021,Sabah,2744,8,173,181,5,189,194,1285,48,0
18/6/2021,Sarawak,8081,2,44,46,4,115,119,3895,915,0
18/6/2021,Selangor,5328,1,790,791,0,762,762,4129,12,40
18/6/2021,Terengganu,2480,14,61,75,11,61,72,315,44,0
18/6/2021,W.P. Labuan,649,10,15,25,2,31,33,235,63,0
19/6/2021,Johor,2084,0,119,119,0,154,154,1100,0,0
19/6/2021,Kedah,540,0,28,28,0,19,19,320,0,0
19/6/2021,Kelantan,2716,7,109,116,6,203,209,994,71,0
19/6/2021,Melaka,1778,0,105,105,0,77,77,500,0,0
19/6/2021,Negeri Sembilan,2395,0,263,263,0,144,144,1034,0,0
19/6/2021,Pahang,1228,42,5,47,10,35,45,89,119,0
19/6/2021,Perak,1107,0,64,64,0,81,81,368,0,156
19/6/2021,Perlis,314,0,0,0,0,2,2,3,0,0
19/6/2021,Pulau Pinang,1877,0,141,141,0,84,84,604,0,0
19/6/2021,Sabah,2684,11,149,160,6,254,260,1148,44,0
19/6/2021,Sarawak,8081,9,74,83,3,52,55,3866,911,0
19/6/2021,Selangor,5328,2,1699,1701,2,811,813,4035,11,40
19/6/2021,Terengganu,2178,18,21,39,7,44,51,289,53,0
19/6/2021,W.P. Labuan,649,12,14,26,0,0,0,219,74,0
20/6/2021,Johor,2084,0,124,124,0,122,122,1094,0,0
20/6/2021,Kedah,540,0,43,43,0,28,28,334,0,0
20/6/2021,Kelantan,2716,8,99,107,4,150,154,943,75,0
20/6/2021,Melaka,1778,0,76,76,0,89,89,487,0,0
20/6/2021,Negeri Sembilan,2395,0,265,265,0,136,136,1179,0,0
20/6/2021,Pahang,2908,0,44,44,4,46,50,285,10,0
20/6/2021,Perak,1107,0,117,117,0,49,49,436,0,173
20/6/2021,Perlis,314,0,0,0,0,1,1,0,0,0
20/6/2021,Pulau Pinang,1877,0,72,72,0,106,106,572,0,0
20/6/2021,Sabah,2655,11,210,221,2,189,191,1153,46,0
20/6/2021,Sarawak,8081,6,39,45,0,77,77,3772,862,0
20/6/2021,Selangor,5668,3,858,861,2,690,692,4206,9,40
20/6/2021,Terengganu,2178,7,48,55,21,58,79,279,39,0
20/6/2021,W.P. Labuan,649,7,32,39,3,19,22,234,78,0
21/6/2021,Johor,2084,0,290,290,0,124,124,1248,0,0
21/6/2021,Kedah,540,0,42,42,0,93,93,280,0,0
21/6/2021,Kelantan,2716,13,123,136,9,139,148,927,79,0
21/6/2021,Melaka,1782,0,141,141,0,73,73,555,0,0
21/6/2021,Negeri Sembilan,2395,0,113,113,0,147,147,1132,0,0
21/6/2021,Pahang,2908,3,52,55,4,48,52,289,11,0
21/6/2021,Perak,1107,0,159,159,0,70,70,524,0,178
21/6/2021,Perlis,314,0,0,0,0,0,0,0,0,0
21/6/2021,Pulau Pinang,1877,0,94,94,0,163,163,504,0,0
21/6/2021,Sabah,2655,7,127,134,9,204,213,1059,45,0
21/6/2021,Sarawak,8081,190,41,231,5,43,48,3868,1054,0
21/6/2021,Selangor,5668,0,503,503,0,766,766,3944,8,40
21/6/2021,Terengganu,1786,11,9,20,2,40,42,248,48,0
21/6/2021,W.P. Labuan,670,7,25,32,5,0,5,245,69,0
22/6/2021,Johor,2084,0,275,275,0,103,103,1408,0,0
22/6/2021,Kedah,540,0,35,35,0,93,93,250,0,0
22/6/2021,Kelantan,2716,11,131,142,18,119,137,939,72,0
22/6/2021,Melaka,1782,0,166,166,0,78,78,643,0,0
22/6/2021,Negeri Sembilan,2395,0,165,165,0,126,126,1158,0,0
22/6/2021,Pahang,2908,3,47,50,3,47,50,272,11,0
22/6/2021,Perak,1107,0,30,30,0,11,11,537,0,161
22/6/2021,Perlis,314,0,0,0,0,0,0,0,0,0
22/6/2021,Pulau Pinang,1877,0,41,41,0,141,141,429,0,0
22/6/2021,Sabah,2612,3,95,98,2,196,198,968,45,0
22/6/2021,Sarawak,8098,100,27,127,305,47,352,3614,1079,0
22/6/2021,Selangor,5668,5,734,739,0,637,637,4044,10,40
22/6/2021,Terengganu,1604,10,12,22,9,40,49,218,49,0
22/6/2021,W.P. Labuan,670,9,47,56,3,18,21,268,68,0
23/6/2021,Johor,2084,0,126,126,0,101,101,1389,0,0
23/6/2021,Kedah,540,17,47,64,0,53,53,236,17,0
23/6/2021,Kelantan,2616,10,118,128,5,138,143,919,77,0
23/6/2021,Melaka,1782,0,94,94,0,65,65,634,0,0
23/6/2021,Negeri Sembilan,2395,0,128,128,0,156,156,1127,0,0
23/6/2021,Pahang,2908,2,71,73,1,32,33,307,13,0
23/6/2021,Perak,1157,0,48,48,0,14,14,569,0,173
23/6/2021,Perlis,314,0,0,0,0,0,0,0,0,0
23/6/2021,Pulau Pinang,1877,0,167,167,0,67,67,541,0,0
23/6/2021,Sabah,2612,6,163,169,4,198,202,928,49,0
23/6/2021,Sarawak,8098,2,50,52,40,97,137,3727,885,0
23/6/2021,Selangor,5668,5,730,735,1,494,495,4332,10,40
23/6/2021,Terengganu,1604,10,25,35,9,44,53,200,51,0
23/6/2021,W.P. Labuan,670,0,6,6,2,29,31,258,58,0
24/6/2021,Johor,2359,0,217,217,0,167,167,1431,0,0
24/6/2021,Kedah,540,0,81,81,0,25,25,262,17,0
24/6/2021,Kelantan,2616,10,47,57,6,161,167,805,81,0
24/6/2021,Melaka,1782,0,111,111,0,90,90,655,0,0
24/6/2021,Negeri Sembilan,2395,0,149,149,0,91,91,1173,0,0
24/6/2021,Pahang,2908,4,99,103,0,46,46,391,14,0
24/6/2021,Perak,1157,0,22,22,0,33,33,555,0,165
24/6/2021,Perlis,314,0,0,0,0,0,0,0,0,0
24/6/2021,Pulau Pinang,1877,0,46,46,0,77,77,509,0,0
24/6/2021,Sabah,2612,9,146,155,11,150,161,917,50,0
24/6/2021,Sarawak,8198,1,30,31,3,70,73,3746,885,0
24/6/2021,Selangor,5668,5,823,828,4,689,693,4469,8,40
24/6/2021,Terengganu,1604,6,20,26,17,45,62,175,40,0
24/6/2021,W.P. Labuan,670,9,36,45,0,16,16,278,62,0
25/6/2021,Johor,2388,0,199,199,0,158,158,1463,0,0
25/6/2021,Kedah,540,0,66,66,0,46,46,280,17,0
25/6/2021,Kelantan,2604,7,92,99,3,96,99,801,85,0
25/6/2021,Melaka,1782,0,95,95,0,88,88,662,0,0
25/6/2021,Negeri Sembilan,2395,0,220,220,0,156,156,1126,0,0
25/6/2021,Pahang,2908,14,162,176,3,44,47,505,25,0
25/6/2021,Perak,807,0,25,25,0,61,61,183,0,169
25/6/2021,Perlis,314,0,0,0,0,0,0,0,0,0
25/6/2021,Pulau Pinang,1877,0,55,55,0,148,148,416,0,0
25/6/2021,Sabah,2642,7,98,105,4,179,183,847,46,0
25/6/2021,Sarawak,8198,2,146,148,4,42,46,3713,848,0
25/6/2021,Selangor,5668,4,916,920,3,862,865,4528,4,40
25/6/2021,Terengganu,1604,6,24,30,16,46,62,153,30,0
25/6/2021,W.P. Labuan,670,9,58,67,7,37,44,277,68,0
26/6/2021,Johor,2388,0,128,128,0,201,201,1386,0,0
26/6/2021,Kedah,540,0,72,72,0,27,27,318,5,0
26/6/2021,Kelantan,2604,5,51,56,15,136,151,714,75,0
26/6/2021,Melaka,1782,0,167,167,0,64,64,765,0,0
26/6/2021,Negeri Sembilan,2395,0,304,304,0,174,174,1244,0,0
26/6/2021,Pahang,2908,3,76,79,3,23,26,563,24,0
26/6/2021,Perak,1157,0,26,26,0,106,106,338,0,155
26/6/2021,Perlis,314,0,0,0,0,0,0,0,0,0
26/6/2021,Pulau Pinang,1877,0,205,205,0,73,73,552,0,0
26/6/2021,Sabah,2714,8,137,145,5,111,116,855,47,0
26/6/2021,Sarawak,8198,2,29,31,1,61,62,3728,852,94
26/6/2021,Selangor,5668,1,890,891,0,853,853,4565,5,40
26/6/2021,Terengganu,1604,8,26,34,9,23,32,156,29,629
26/6/2021,W.P. Labuan,670,8,33,41,5,0,5,266,69,0
27/6/2021,Johor,2388,0,139,139,0,244,244,1278,0,0
27/6/2021,Kedah,540,0,49,49,0,30,30,321,0,0
27/6/2021,Kelantan,2563,10,62,72,15,100,115,676,70,0
27/6/2021,Melaka,1782,0,189,189,0,74,74,866,0,0
27/6/2021,Negeri Sembilan,2395,0,205,205,0,134,134,1303,0,0
27/6/2021,Pahang,2908,3,154,157,0,10,10,707,24,0
27/6/2021,Perak,1157,0,32,32,0,14,14,349,0,155
27/6/2021,Perlis,314,0,0,0,0,0,0,0,0,0
27/6/2021,Pulau Pinang,1877,0,117,117,0,79,79,587,0,0
27/6/2021,Sabah,2674,9,171,180,4,117,121,872,44,0
27/6/2021,Sarawak,8030,6,23,29,0,69,69,3685,884,0
27/6/2021,Selangor,5668,1,867,868,0,798,798,4634,6,0
27/6/2021,Terengganu,1604,9,19,28,13,41,54,134,25,0
27/6/2021,W.P. Labuan,670,4,41,45,0,78,78,271,69,0
28/6/2021,Johor,2493,0,164,164,0,227,227,1203,0,0
28/6/2021,Kedah,540,0,37,37,0,37,37,322,0,0
28/6/2021,Kelantan,2563,10,90,100,8,99,107,667,72,0
28/6/2021,Melaka,1782,0,107,107,0,190,190,798,0,0
28/6/2021,Negeri Sembilan,2395,0,113,113,0,189,189,1221,0,0
28/6/2021,Pahang,2908,1,83,84,6,6,12,781,23,0
28/6/2021,Perak,1157,0,45,45,0,54,54,334,0,161
28/6/2021,Perlis,314,0,0,0,0,0,0,0,0,0
28/6/2021,Pulau Pinang,1877,0,89,89,0,81,81,589,0,0
28/6/2021,Sabah,2714,11,301,312,9,152,161,1042,39,0
28/6/2021,Sarawak,8030,1,16,17,1,44,45,3492,905,0
28/6/2021,Selangor,5668,8,667,675,0,684,684,4620,11,40
28/6/2021,Terengganu,1604,1,12,13,4,11,15,135,22,0
28/6/2021,W.P. Labuan,476,27,26,53,0,0,0,242,65,0
29/6/2021,Johor,2493,0,153,153,0,217,217,1130,0,0
29/6/2021,Kedah,540,0,36,36,0,38,38,312,0,0
29/6/2021,Kelantan,2563,6,78,84,11,92,103,663,67,0
29/6/2021,Melaka,1782,0,78,78,0,125,125,750,0,0
29/6/2021,Negeri Sembilan,2395,0,125,125,0,202,202,1139,0,0
29/6/2021,Pahang,2908,2,99,101,0,12,12,868,24,0
29/6/2021,Perak,1157,4,126,130,0,34,34,423,4,162
29/6/2021,Perlis,314,0,0,0,0,0,0,0,0,0
29/6/2021,Pulau Pinang,1877,0,78,78,0,71,71,605,0,0
29/6/2021,Sabah,2564,11,144,155,5,133,138,1044,53,0
29/6/2021,Sarawak,8030,6,55,61,31,48,79,3395,845,0
29/6/2021,Selangor,5668,2,809,811,1,675,676,4754,12,40
29/6/2021,Terengganu,1604,5,18,23,2,12,14,141,25,0
29/6/2021,W.P. Labuan,496,5,7,12,4,0,4,236,58,0
30/6/2021,Johor,2493,0,112,112,0,218,218,1019,0,0
30/6/2021,Kedah,540,0,87,87,0,42,42,327,0,0
30/6/2021,Kelantan,2763,11,80,91,7,115,122,675,71,0
30/6/2021,Melaka,1782,0,183,183,0,133,133,800,0,0
30/6/2021,Negeri Sembilan,1995,0,208,208,0,170,170,1174,0,0
30/6/2021,Pahang,2908,0,225,225,0,101,101,992,24,0
30/6/2021,Perak,1157,0,94,94,0,154,154,365,2,163
30/6/2021,Perlis,314,0,0,0,0,0,0,0,0,0
30/6/2021,Pulau Pinang,1877,0,46,46,0,69,69,590,0,0
30/6/2021,Sabah,2564,3,98,101,8,127,135,1006,38,0
30/6/2021,Sarawak,8030,0,10,10,36,33,69,3202,743,35
30/6/2021,Selangor,5668,1,1086,1087,1,672,673,5169,11,40
30/6/2021,Terengganu,1604,6,13,19,3,29,32,125,28,0
30/6/2021,W.P. Labuan,496,4,2,6,19,0,19,219,47,0
1/7/2021,Johor,2321,0,103,103,0,152,152,964,0,0
1/7/2021,Kedah,540,0,71,71,0,55,55,348,0,0
1/7/2021,Kelantan,2763,11,96,107,9,133,142,638,73,0
1/7/2021,Melaka,1662,0,181,181,0,95,95,886,0,0
1/7/2021,Negeri Sembilan,2395,0,191,191,0,98,98,1248,0,0
1/7/2021,Pahang,2908,10,206,216,1,71,72,1126,33,0
1/7/2021,Perak,1157,0,40,40,0,16,16,386,0,174
1/7/2021,Perlis,314,0,0,0,0,0,0,0,0,0
1/7/2021,Pulau Pinang,1877,0,111,111,0,84,84,608,0,0
1/7/2021,Sabah,2534,10,180,190,5,152,157,1059,39,0
1/7/2021,Sarawak,8030,0,61,61,3,57,60,3071,729,0
1/7/2021,Selangor,5668,3,1157,1160,1,853,854,5476,10,40
1/7/2021,Terengganu,1604,5,2,7,11,21,32,106,22,0
1/7/2021,W.P. Labuan,496,2,0,2,1,0,1,206,42,0
2/7/2021,Johor,2292,0,115,115,0,89,89,984,0,0
2/7/2021,Kedah,540,0,61,61,0,55,55,346,0,0
2/7/2021,Kelantan,2299,7,77,84,8,54,62,661,72,0
2/7/2021,Melaka,1782,0,196,196,0,109,109,975,0,0
2/7/2021,Negeri Sembilan,2995,0,166,166,0,411,411,991,0,0
2/7/2021,Pahang,2908,3,208,211,8,38,46,1272,28,0
2/7/2021,Perak,1157,0,67,67,0,13,13,438,0,155
2/7/2021,Perlis,314,0,0,0,0,0,0,0,0,0
2/7/2021,Pulau Pinang,1877,0,119,119,0,135,135,577,0,0
2/7/2021,Sabah,2564,9,214,223,8,138,146,1145,43,0
2/7/2021,Sarawak,7858,1,68,69,0,40,40,2900,707,0
2/7/2021,Selangor,5668,2,653,655,3,905,908,5224,9,40
2/7/2021,Terengganu,1604,1,0,1,1,10,11,96,22,0
2/7/2021,W.P. Labuan,516,12,31,43,2,22,24,210,45,0
3/7/2021,Johor,2292,0,164,164,0,106,106,1039,0,0
3/7/2021,Kedah,540,0,68,68,0,54,54,352,0,0
3/7/2021,Kelantan,2299,7,86,93,11,100,111,647,68,0
3/7/2021,Melaka,1782,0,114,114,0,109,109,970,0,0
3/7/2021,Negeri Sembilan,2995,0,168,168,0,206,206,1081,0,0
3/7/2021,Pahang,2908,4,242,246,1,34,35,1459,31,0
3/7/2021,Perak,1157,0,103,103,0,28,28,510,0,176
3/7/2021,Perlis,314,0,0,0,0,0,0,0,0,0
3/7/2021,Pulau Pinang,1877,0,228,228,0,105,105,699,0,0
3/7/2021,Sabah,2564,8,203,211,7,117,124,1202,46,0
3/7/2021,Sarawak,7858,6,61,67,2,113,115,2734,650,0
3/7/2021,Selangor,5668,0,634,634,1,1072,1073,4787,7,40
3/7/2021,Terengganu,1604,5,2,7,5,26,31,63,22,0
3/7/2021,W.P. Labuan,441,0,18,18,6,33,39,202,32,0
4/7/2021,Johor,2397,0,99,99,0,171,171,961,0,0
4/7/2021,Kedah,540,0,59,59,0,56,56,356,0,0
4/7/2021,Kelantan,2299,14,74,88,14,62,76,660,68,0
4/7/2021,Melaka,1742,0,181,181,0,141,141,1027,0,0
4/7/2021,Negeri Sembilan,2898,0,197,197,0,142,142,1128,0,0
4/7/2021,Pahang,2908,10,144,154,12,34,46,1303,295,0
4/7/2021,Perak,1157,0,33,33,0,34,34,506,0,174
4/7/2021,Perlis,314,0,0,0,0,0,0,0,0,0
4/7/2021,Pulau Pinang,1877,0,91,91,0,107,107,679,0,0
4/7/2021,Sabah,2604,6,220,226,5,136,141,1297,48,0
4/7/2021,Sarawak,7858,1,96,97,180,37,217,2638,449,19
4/7/2021,Selangor,5668,0,1059,1059,4,942,946,4904,3,40
4/7/2021,Terengganu,1604,4,1,5,15,22,37,42,11,0
4/7/2021,W.P. Labuan,441,17,36,53,0,37,37,196,42,0
5/7/2021,Johor,2397,0,179,179,0,125,125,988,0,0
5/7/2021,Kedah,540,0,64,64,0,27,27,373,0,0
5/7/2021,Kelantan,2299,10,103,113,11,76,87,686,68,0
5/7/2021,Melaka,1749,0,140,140,0,139,139,982,0,0
5/7/2021,Negeri Sembilan,2898,0,141,141,0,211,211,1028,0,0
5/7/2021,Pahang,2908,4,122,126,0,141,141,1544,39,0
5/7/2021,Perak,1157,0,21,21,0,47,47,472,0,193
5/7/2021,Perlis,214,0,0,0,0,0,0,0,0,0
5/7/2021,Pulau Pinang,1877,0,130,130,0,76,76,746,0,0
5/7/2021,Sabah,2540,10,146,156,4,188,192,1233,49,0
5/7/2021,Sarawak,7858,139,25,164,98,24,122,2562,483,0
5/7/2021,Selangor,5668,1,848,849,1,931,932,4802,2,40
5/7/2021,Terengganu,1604,1,38,39,2,3,5,77,11,0
5/7/2021,W.P. Labuan,441,20,20,40,1,14,15,202,61,0
6/7/2021,Johor,2397,0,147,147,0,120,120,1008,0,0
6/7/2021,Kedah,540,0,58,58,0,39,39,361,0,0
6/7/2021,Kelantan,2299,5,76,81,6,70,76,692,67,0
6/7/2021,Melaka,1749,0,109,109,0,133,133,958,0,0
6/7/2021,Negeri Sembilan,2898,0,254,254,0,238,238,1016,0,0
6/7/2021,Pahang,2908,10,127,137,8,82,90,1589,41,316
6/7/2021,Perak,1157,0,45,45,0,75,75,439,0,171
6/7/2021,Perlis,214,0,0,0,0,0,0,0,0,0
6/7/2021,Pulau Pinang,1877,0,113,113,0,97,97,750,0,0
6/7/2021,Sabah,2604,4,155,159,6,177,183,1224,44,0
6/7/2021,Sarawak,8361,0,8,8,9,72,81,2649,448,0
6/7/2021,Selangor,5668,1,687,688,0,965,965,4524,3,40
6/7/2021,Terengganu,1604,4,15,19,5,21,26,71,10,0
6/7/2021,W.P. Labuan,441,3,25,28,3,34,37,193,55,0
7/7/2021,Johor,2397,0,147,147,0,92,92,1056,0,0
7/7/2021,Kedah,540,0,96,96,0,58,58,423,0,0
7/7/2021,Kelantan,2299,17,79,96,16,93,109,678,68,0
7/7/2021,Melaka,1749,0,152,152,0,66,66,1033,0,0
7/7/2021,Negeri Sembilan,2104,0,160,160,0,134,134,999,0,0
7/7/2021,Pahang,2908,4,132,136,8,147,155,1574,36,0
7/7/2021,Perak,1157,0,23,23,0,52,52,406,0,161
7/7/2021,Perlis,214,0,0,0,0,0,0,0,0,0
7/7/2021,Pulau Pinang,1877,0,66,66,0,47,47,765,0,0
7/7/2021,Sabah,2715,5,190,195,3,181,184,1219,46,0
7/7/2021,Sarawak,8361,11,28,39,2,47,49,2561,470,0
7/7/2021,Selangor,5668,3,955,958,1,720,721,4760,4,40
7/7/2021,Terengganu,1604,0,43,43,3,18,21,96,7,0
7/7/2021,W.P. Labuan,441,11,33,44,6,44,50,182,58,0
8/7/2021,Johor,2502,0,142,142,0,112,112,1080,0,0
8/7/2021,Kedah,540,0,32,32,0,67,67,413,0,0
8/7/2021,Kelantan,2299,12,106,118,9,110,119,674,71,0
8/7/2021,Melaka,1749,0,151,151,0,225,225,960,0,0
8/7/2021,Negeri Sembilan,2104,0,215,215,0,202,202,993,0,0
8/7/2021,Pahang,2908,9,171,180,3,165,168,1580,42,0
8/7/2021,Perak,1157,0,80,80,0,63,63,420,0,166
8/7/2021,Perlis,214,0,0,0,0,0,0,0,0,0
8/7/2021,Pulau Pinang,1877,0,90,90,0,122,122,762,0,0
8/7/2021,Sabah,2685,19,253,272,4,172,176,1319,64,0
8/7/2021,Sarawak,8361,5,25,30,0,32,32,2425,414,0
8/7/2021,Selangor,5668,0,663,663,0,952,952,4473,2,40
8/7/2021,Terengganu,1604,6,28,34,1,0,1,124,12,0
8/7/2021,W.P. Labuan,441,18,33,51,8,26,34,189,56,0
9/7/2021,Johor,2502,0,206,206,0,126,126,1154,0,0
9/7/2021,Kedah,540,1,91,92,0,54,54,427,1,0
9/7/2021,Kelantan,2299,9,62,71,10,86,96,650,70,0
9/7/2021,Melaka,1749,0,137,137,0,124,124,973,0,0
9/7/2021,Negeri Sembilan,2104,0,173,173,0,175,175,983,0,0
9/7/2021,Pahang,2908,2,189,191,0,136,136,1634,41,0
9/7/2021,Perak,1157,0,88,88,0,85,85,421,2,170
9/7/2021,Perlis,214,0,0,0,0,0,0,0,0,0
9/7/2021,Pulau Pinang,1877,0,154,154,0,153,153,777,0,0
9/7/2021,Sabah,2695,11,258,269,5,119,124,1429,60,0
9/7/2021,Sarawak,8361,6,68,74,1,57,58,2342,414,0
9/7/2021,Selangor,5668,1,209,210,0,1077,1077,3606,2,40
9/7/2021,Terengganu,1604,5,41,46,2,2,4,162,16,0
9/7/2021,W.P. Labuan,441,22,23,45,2,16,18,169,66,0
10/7/2021,Johor,2502,0,183,183,0,94,94,1230,0,0
10/7/2021,Kedah,540,1,62,63,0,70,70,408,1,0
10/7/2021,Kelantan,2299,15,109,124,9,101,110,658,76,0
10/7/2021,Melaka,1749,0,92,92,0,166,166,877,0,0
10/7/2021,Negeri Sembilan,2104,0,173,173,0,181,181,963,0,0
10/7/2021,Pahang,2908,3,114,117,0,129,129,1619,41,0
10/7/2021,Perak,1133,0,51,51,0,67,67,378,0,117
10/7/2021,Perlis,214,0,0,0,0,0,0,0,0,0
10/7/2021,Pulau Pinang,1877,0,70,70,0,246,246,610,0,0
10/7/2021,Sabah,2780,11,251,262,4,126,130,1514,71,0
10/7/2021,Sarawak,8204,1,61,62,0,83,83,2213,410,0
10/7/2021,Selangor,5668,4,269,273,0,829,829,3047,5,40
10/7/2021,Terengganu,1604,8,67,75,1,5,6,224,23,0
10/7/2021,W.P. Labuan,441,0,55,55,6,29,35,195,36,0
11/7/2021,Johor,2502,0,209,209,0,171,171,1260,0,0
11/7/2021,Kedah,540,0,93,93,0,70,70,407,0,0
11/7/2021,Kelantan,2299,10,66,76,9,69,78,655,77,0
11/7/2021,Melaka,1749,0,219,219,0,221,221,879,0,0
11/7/2021,Negeri Sembilan,2104,0,146,146,0,166,166,937,0,0
11/7/2021,Pahang,2908,4,165,169,0,120,120,1663,44,0
11/7/2021,Perak,1157,0,44,44,0,19,19,415,1,181
11/7/2021,Perlis,214,0,0,0,0,0,0,0,0,0
11/7/2021,Pulau Pinang,1877,0,105,105,0,126,126,612,0,0
11/7/2021,Sabah,2922,21,245,266,8,276,284,1467,79,0
11/7/2021,Sarawak,8676,1,36,37,2,29,31,2302,393,0
11/7/2021,Selangor,5668,4,394,398,0,654,654,2791,5,40
11/7/2021,Terengganu,1604,2,47,49,3,3,6,268,22,0
11/7/2021,W.P. Labuan,441,11,10,21,1,22,23,155,42,0
12/7/2021,Johor,2502,0,245,245,0,119,119,1368,0,0
12/7/2021,Kedah,540,0,69,69,0,44,44,430,0,0
12/7/2021,Kelantan,2299,14,103,117,8,78,86,680,83,0
12/7/2021,Melaka,1749,0,187,187,0,180,180,886,0,0
12/7/2021,Negeri Sembilan,2104,0,119,119,0,210,210,834,0,0
12/7/2021,Pahang,2908,6,198,204,11,152,163,1704,36,0
12/7/2021,Perak,1157,0,73,73,0,89,89,396,0,161
12/7/2021,Perlis,214,0,0,0,0,0,0,0,0,0
12/7/2021,Pulau Pinang,1877,0,96,96,0,132,132,590,0,0
12/7/2021,Sabah,2858,13,327,340,10,164,174,1561,77,0
12/7/2021,Sarawak,8676,3,19,22,3,49,52,2223,367,0
12/7/2021,Selangor,5668,3,346,349,0,690,690,2447,8,40
12/7/2021,Terengganu,1604,4,44,48,1,13,14,299,25,0
12/7/2021,W.P. Labuan,441,0,33,33,2,34,36,154,32,0
13/7/2021,Johor,2562,0,202,202,0,100,100,1467,0,0
13/7/2021,Kedah,540,0,48,48,0,98,98,394,0,0
13/7/2021,Kelantan,2299,12,99,111,19,78,97,701,76,0
13/7/2021,Melaka,1749,0,152,152,0,156,156,886,0,0
13/7/2021,Negeri Sembilan,2104,0,397,397,0,290,290,926,0,0
13/7/2021,Pahang,2908,9,242,251,1,174,175,1772,47,0
13/7/2021,Perak,1157,0,70,70,0,37,37,418,0,180
13/7/2021,Perlis,214,0,0,0,0,0,0,0,0,0
13/7/2021,Pulau Pinang,1877,0,76,76,0,125,125,572,0,0
13/7/2021,Sabah,2891,9,237,246,8,153,161,1653,78,0
13/7/2021,Sarawak,8696,0,14,14,0,27,27,2288,258,0
13/7/2021,Selangor,5668,1,358,359,1,534,535,2274,5,40
13/7/2021,Terengganu,1604,13,105,118,1,25,26,379,37,0
13/7/2021,W.P. Labuan,441,20,56,76,8,41,49,169,44,0
14/7/2021,Johor,2562,0,259,259,0,128,128,1590,0,0
14/7/2021,Kedah,540,0,95,95,0,59,59,417,0,0
14/7/2021,Kelantan,2299,17,162,179,16,108,124,755,77,0
14/7/2021,Melaka,1749,0,307,307,0,125,125,1068,0,0
14/7/2021,Negeri Sembilan,2104,0,225,225,0,139,139,997,0,0
14/7/2021,Pahang,2908,7,142,149,0,269,269,1652,51,0
14/7/2021,Perak,1157,0,70,70,0,27,27,464,0,170
14/7/2021,Perlis,214,0,0,0,0,0,0,0,0,0
14/7/2021,Pulau Pinang,1877,0,177,177,0,75,75,697,0,0
14/7/2021,Sabah,2741,6,206,212,5,229,234,1593,71,0
14/7/2021,Sarawak,8310,3,77,80,1,24,25,2395,354,0
14/7/2021,Selangor,5146,2,467,469,1,473,474,2270,3,40
14/7/2021,Terengganu,1604,4,43,47,6,48,54,374,35,0
14/7/2021,W.P. Labuan,441,17,20,37,5,31,36,158,56,0
15/7/2021,Johor,2562,0,324,324,0,170,170,1274,0,0
15/7/2021,Kedah,540,0,75,75,0,82,82,396,0,0
15/7/2021,Kelantan,2299,12,164,176,11,80,91,839,78,0
15/7/2021,Melaka,1749,0,218,218,0,147,147,1139,0,0
15/7/2021,Negeri Sembilan,2104,0,235,235,0,117,117,1108,0,0
15/7/2021,Pahang,2908,2,175,177,7,256,263,1553,46,0
15/7/2021,Perak,1157,0,90,90,0,19,19,518,1,181
15/7/2021,Perlis,214,0,0,0,0,0,0,0,0,0
15/7/2021,Pulau Pinang,1877,0,84,84,0,125,125,688,0,0
15/7/2021,Sabah,2701,10,278,288,14,163,177,1741,60,0
15/7/2021,Sarawak,7959,1,32,33,1,105,106,2230,378,0
15/7/2021,Selangor,5146,3,343,346,0,495,495,2119,5,40
15/7/2021,Terengganu,1604,5,192,197,8,26,34,540,32,0
15/7/2021,W.P. Labuan,441,0,29,29,4,20,24,167,49,0
16/7/2021,Johor,2562,0,347,347,0,156,156,1417,0,0
16/7/2021,Kedah,540,0,77,77,0,76,76,384,0,0
16/7/2021,Kelantan,2299,7,151,158,5,81,86,909,80,0
16/7/2021,Melaka,1749,0,274,274,0,235,235,1178,0,0
16/7/2021,Negeri Sembilan,2104,0,219,219,0,171,171,1144,0,0
16/7/2021,Pahang,2908,14,240,254,5,178,183,1609,55,0
16/7/2021,Perak,1197,0,92,92,0,54,54,545,1,176
16/7/2021,Perlis,214,0,0,0,0,0,0,0,0,0
16/7/2021,Pulau Pinang,1877,0,245,245,0,92,92,841,0,0
16/7/2021,Sabah,3069,4,315,319,7,198,205,1737,56,0
16/7/2021,Sarawak,7959,7,58,65,3,40,43,2289,366,0
16/7/2021,Selangor,5146,0,267,267,0,255,255,2140,5,0
16/7/2021,Terengganu,1604,8,67,75,8,38,46,569,32,0
16/7/2021,W.P. Labuan,441,4,26,30,4,12,16,184,41,0
17/7/2021,Johor,2562,0,267,267,0,171,171,1979,0,0
17/7/2021,Kedah,540,0,70,70,0,56,56,385,0,0
17/7/2021,Kelantan,1653,4,166,170,12,97,109,978,72,0
17/7/2021,Melaka,1749,0,204,204,0,230,230,1152,0,0
17/7/2021,Negeri Sembilan,2104,0,231,231,0,269,269,1097,0,0
17/7/2021,Pahang,2908,78,200,278,3,209,212,1629,59,0
17/7/2021,Perak,1200,0,198,198,0,71,71,660,0,184
17/7/2021,Perlis,214,0,0,0,0,0,0,0,0,0
17/7/2021,Pulau Pinang,1864,0,182,182,0,143,143,874,0,0
17/7/2021,Sabah,3069,12,806,818,9,240,249,2266,44,0
17/7/2021,Sarawak,7959,1,38,39,1,23,24,2324,365,0
17/7/2021,Selangor,5146,0,327,327,3,353,356,2178,6,0
17/7/2021,Terengganu,1604,4,92,96,4,90,94,571,44,0
17/7/2021,W.P. Labuan,441,13,10,23,2,33,35,158,52,0
18/7/2021,Johor,2562,0,216,216,0,206,206,1970,0,0
18/7/2021,Kedah,540,1,70,71,0,70,70,370,1,0
18/7/2021,Kelantan,2299,7,169,176,9,96,105,1051,70,0
18/7/2021,Melaka,1749,0,194,194,0,198,198,1148,0,0
18/7/2021,Negeri Sembilan,2104,0,230,230,0,217,217,975,0,0
18/7/2021,Pahang,2908,2,269,271,4,140,144,1758,56,0
18/7/2021,Perak,1200,0,68,68,0,70,70,652,0,201
18/7/2021,Perlis,214,0,1,1,0,0,0,1,0,0
18/7/2021,Pulau Pinang,1871,0,217,217,0,128,128,960,0,0
18/7/2021,Sabah,3219,45,416,461,5,224,229,2488,93,0
18/7/2021,Sarawak,7959,2,30,32,137,43,180,2174,220,0
18/7/2021,Selangor,5146,2,382,384,1,377,378,2178,7,0
18/7/2021,Terengganu,1604,19,131,150,3,7,10,186,10,0
18/7/2021,W.P. Labuan,441,28,30,58,9,11,20,156,71,0
19/7/2021,Johor,2562,0,351,351,0,198,198,2117,0,0
19/7/2021,Kedah,540,0,81,81,0,55,55,372,1,0
19/7/2021,Kelantan,2299,4,118,122,8,102,110,1067,66,0
19/7/2021,Melaka,1749,0,174,174,0,145,145,1164,0,0
19/7/2021,Negeri Sembilan,2104,0,202,202,0,190,190,1092,0,0
19/7/2021,Pahang,2908,7,215,222,10,149,159,1822,47,0
19/7/2021,Perak,1200,0,86,86,0,42,42,687,0,207
19/7/2021,Perlis,214,0,0,0,0,0,0,1,0,0
19/7/2021,Pulau Pinang,1871,0,118,118,0,140,140,937,0,0
19/7/2021,Sabah,4009,17,399,416,3,211,214,2676,98,0
19/7/2021,Sarawak,7959,4,26,30,3,19,22,2181,216,32
19/7/2021,Selangor,5146,1,249,250,6,320,326,2123,8,0
19/7/2021,Terengganu,1604,4,122,126,6,43,49,697,55,0
19/7/2021,W.P. Labuan,441,14,15,29,5,8,13,136,77,0
20/7/2021,Johor,2562,0,381,381,0,177,177,2308,0,0
20/7/2021,Kedah,540,0,77,77,0,50,50,387,1,0
20/7/2021,Kelantan,2411,17,156,173,8,91,99,1130,75,0
20/7/2021,Melaka,1642,0,236,236,0,225,225,1175,0,0
20/7/2021,Negeri Sembilan,2104,0,392,392,0,275,275,1190,0,0
20/7/2021,Pahang,2908,13,295,308,0,193,193,1923,66,0
20/7/2021,Perak,1200,0,189,189,0,38,38,820,0,161
20/7/2021,Perlis,214,0,0,0,0,0,0,1,0,0
20/7/2021,Pulau Pinang,1871,0,161,161,0,183,183,914,0,0
20/7/2021,Sabah,4559,11,350,361,4,222,226,2767,101,0
20/7/2021,Sarawak,7959,2,28,30,0,64,64,2250,219,0
20/7/2021,Selangor,5146,0,213,213,0,260,260,2153,6,0
20/7/2021,Terengganu,1604,19,121,140,6,60,66,757,68,0
20/7/2021,W.P. Labuan,441,0,47,47,5,37,42,112,58,0
21/7/2021,Johor,2608,0,158,158,0,164,164,2343,0,0
21/7/2021,Kedah,540,0,95,95,0,56,56,415,0,0
21/7/2021,Kelantan,2411,9,116,125,14,129,143,1117,70,0
21/7/2021,Melaka,1642,0,200,200,0,119,119,1242,0,0
21/7/2021,Negeri Sembilan,2104,0,169,169,0,97,97,1245,0,0
21/7/2021,Pahang,2908,4,307,311,10,200,210,2032,60,0
21/7/2021,Perak,1200,0,77,77,0,81,81,798,0,179
21/7/2021,Perlis,214,0,0,0,0,0,0,1,0,0
21/7/2021,Pulau Pinang,1871,0,177,177,0,148,148,942,0,0
21/7/2021,Sabah,4623,12,333,345,5,275,280,2845,98,0
21/7/2021,Sarawak,2425,3,123,126,0,9,9,2345,212,0
21/7/2021,Selangor,5146,2,403,405,0,341,341,2203,5,0
21/7/2021,Terengganu,1604,18,147,165,10,94,104,810,76,0
21/7/2021,W.P. Labuan,441,8,16,24,5,6,11,139,61,0
22/7/2021,Johor,2807,0,279,279,0,270,270,2343,0,0
22/7/2021,Kedah,540,0,88,88,0,72,72,419,0,0
22/7/2021,Kelantan,2411,9,261,270,11,173,184,1205,68,0
22/7/2021,Melaka,1642,0,186,186,0,196,196,1232,0,0
22/7/2021,Negeri Sembilan,2104,0,199,199,0,135,135,1294,0,0
22/7/2021,Pahang,2908,6,365,371,19,216,235,2192,47,0
22/7/2021,Perak,1234,0,94,94,0,73,73,793,2,186
22/7/2021,Perlis,214,11,0,11,0,0,0,4,11,0
22/7/2021,Pulau Pinang,1871,0,186,186,0,191,191,938,0,0
22/7/2021,Sabah,4643,15,362,377,33,282,315,2891,66,0
22/7/2021,Sarawak,7525,13,89,102,2,92,94,2352,194,0
22/7/2021,Selangor,5188,1,259,260,0,323,323,2212,5,1
22/7/2021,Terengganu,1508,23,135,158,8,82,90,863,88,0
22/7/2021,W.P. Labuan,441,3,35,38,3,4,7,152,43,0
23/7/2021,Johor,2807,0,474,474,0,389,389,2422,0,0
23/7/2021,Kedah,540,0,56,56,0,69,69,401,0,0
23/7/2021,Kelantan,2411,10,175,185,17,127,144,1253,61,0
23/7/2021,Melaka,1642,0,138,138,0,223,223,1147,0,0
23/7/2021,Negeri Sembilan,2104,0,186,186,0,263,263,1201,0,0
23/7/2021,Pahang,3106,7,210,217,4,149,153,2255,50,0
23/7/2021,Perak,1271,0,121,121,0,71,71,826,2,191
23/7/2021,Perlis,214,0,1,1,0,0,0,10,11,0
23/7/2021,Pulau Pinang,1871,0,152,152,0,161,161,929,0,0
23/7/2021,Sabah,4737,18,362,380,4,305,309,2939,83,0
23/7/2021,Sarawak,7375,2,103,105,0,34,34,2565,200,0
23/7/2021,Selangor,5188,0,316,316,0,385,385,2212,4,0
23/7/2021,Terengganu,1604,30,174,204,11,81,92,956,105,0
23/7/2021,W.P. Labuan,441,18,4,22,7,2,9,137,53,0
24/7/2021,Johor,2816,0,266,266,0,258,258,2419,0,0
24/7/2021,Kedah,540,0,62,62,0,37,37,388,0,0
24/7/2021,Kelantan,2351,9,252,261,11,166,177,1339,59,0
24/7/2021,Melaka,1642,0,2,2,0,3,3,1146,0,0
24/7/2021,Negeri Sembilan,2104,0,240,240,0,223,223,1210,0,0
24/7/2021,Pahang,3106,3,269,272,1,133,134,2385,54,0
24/7/2021,Perak,1289,0,139,139,0,93,93,841,0,157
24/7/2021,Perlis,214,0,0,0,11,0,11,9,0,0
24/7/2021,Pulau Pinang,1871,0,175,175,0,235,235,885,0,0
24/7/2021,Sabah,4741,10,298,308,9,510,519,2734,74,0
24/7/2021,Sarawak,7105,0,48,48,0,20,20,2604,181,0
24/7/2021,Selangor,5188,1,333,334,0,325,325,2226,8,81
24/7/2021,Terengganu,1604,51,269,320,11,153,164,1072,145,0
24/7/2021,W.P. Labuan,441,14,7,21,1,13,14,118,59,0
25/7/2021,Johor,2816,0,267,267,0,327,327,2350,0,0
25/7/2021,Kedah,540,0,33,33,0,59,59,352,0,0
25/7/2021,Kelantan,2351,13,345,358,15,190,205,1494,57,0
25/7/2021,Melaka,1642,0,77,77,0,211,211,985,0,0
25/7/2021,Negeri Sembilan,2104,0,161,161,0,171,171,1193,0,0
25/7/2021,Pahang,3106,0,282,282,13,134,147,2528,39,0
25/7/2021,Perak,1289,0,142,142,0,98,98,866,1,200
25/7/2021,Perlis,214,0,0,0,0,0,0,9,1,0
25/7/2021,Pulau Pinang,1871,0,187,187,0,196,196,903,0,0
25/7/2021,Sabah,4773,18,612,630,3,396,399,2627,92,0
25/7/2021,Sarawak,7205,1,50,51,1,36,37,2796,168,0
25/7/2021,Selangor,5188,14,453,467,0,419,419,2285,10,0
25/7/2021,Terengganu,2354,38,140,178,23,120,143,1091,160,0
25/7/2021,W.P. Labuan,345,15,29,44,0,0,0,124,49,0
26/7/2021,Johor,2816,0,388,388,0,310,310,2422,0,0
26/7/2021,Kedah,540,0,58,58,0,78,78,315,0,0
26/7/2021,Kelantan,2665,11,191,202,16,181,197,1494,52,0
26/7/2021,Melaka,1642,0,5,5,0,0,0,990,0,0
26/7/2021,Negeri Sembilan,2104,0,153,153,0,278,278,1052,0,0
26/7/2021,Pahang,3106,16,229,245,5,202,207,2558,50,0
26/7/2021,Perak,1291,0,212,212,0,74,74,979,6,195
26/7/2021,Perlis,214,0,4,4,0,0,0,11,1,0
26/7/2021,Pulau Pinang,1871,0,190,190,0,218,218,881,0,0
26/7/2021,Sabah,4846,13,558,571,13,432,445,2593,83,0
26/7/2021,Sarawak,7155,2,50,52,4,45,49,2796,166,0
26/7/2021,Selangor,4556,1,404,405,1,372,373,2372,12,0
26/7/2021,Terengganu,2354,44,329,373,34,118,152,1302,170,0
26/7/2021,W.P. Labuan,345,0,16,16,3,3,6,98,40,0
27/7/2021,Johor,2819,0,403,403,0,465,465,2387,0,0
27/7/2021,Kedah,540,0,53,53,0,75,75,285,0,0
27/7/2021,Kelantan,2665,8,245,253,13,125,138,1614,47,0
27/7/2021,Melaka,1642,0,151,151,0,160,160,843,0,0
27/7/2021,Negeri Sembilan,2104,0,264,264,0,333,333,970,0,0
27/7/2021,Pahang,3106,3,296,299,3,233,236,2572,44,0
27/7/2021,Perak,1291,0,143,143,0,168,168,942,0,184
27/7/2021,Perlis,214,0,0,0,1,0,1,19,0,0
27/7/2021,Pulau Pinang,1871,0,203,203,0,154,154,931,0,0
27/7/2021,Sabah,4846,16,448,464,1,386,387,2590,93,0
27/7/2021,Sarawak,7155,3,49,52,0,37,37,2620,157,0
27/7/2021,Selangor,4556,1,342,343,3,382,385,2415,9,0
27/7/2021,Terengganu,2354,22,179,201,26,142,168,1338,166,0
27/7/2021,W.P. Labuan,345,12,8,20,9,2,11,84,31,0
28/7/2021,Johor,2819,0,265,265,0,283,283,2367,0,0
28/7/2021,Kedah,540,1,77,78,0,61,61,286,1,0
28/7/2021,Kelantan,2725,14,309,323,13,203,216,1720,48,0
28/7/2021,Melaka,1642,0,5,5,0,0,0,848,0,0
28/7/2021,Negeri Sembilan,2104,0,190,190,0,121,121,1029,0,0
28/7/2021,Pahang,3106,7,215,222,5,211,216,2571,49,0
28/7/2021,Perak,1341,0,234,234,0,67,67,1089,0,191
28/7/2021,Perlis,214,3,1,4,0,0,0,15,3,0
28/7/2021,Pulau Pinang,1871,0,227,227,0,173,173,980,0,0
28/7/2021,Sabah,4940,16,485,501,10,418,428,2578,87,0
28/7/2021,Sarawak,7155,2,101,103,2,98,100,2571,160,0
28/7/2021,Selangor,4536,0,516,516,0,335,335,2602,11,0
28/7/2021,Terengganu,2354,39,270,309,80,200,280,1400,139,0
28/7/2021,W.P. Labuan,345,6,17,23,4,6,10,79,29,0
29/7/2021,Johor,2830,0,382,382,0,373,373,2366,0,0
29/7/2021,Kedah,540,1,85,86,0,59,59,304,1,0
29/7/2021,Kelantan,2725,18,285,303,9,227,236,1778,57,0
29/7/2021,Melaka,1642,0,138,138,0,190,190,774,0,0
29/7/2021,Negeri Sembilan,2104,0,261,261,0,153,153,1130,0,0
29/7/2021,Pahang,3106,4,369,373,2,263,265,2666,51,0
29/7/2021,Perak,1341,1,99,100,0,140,140,1033,0,210
29/7/2021,Perlis,214,3,3,6,0,0,0,18,3,0
29/7/2021,Pulau Pinang,1871,0,235,235,0,175,175,988,0,0
29/7/2021,Sabah,5444,33,538,571,7,371,378,2977,120,0
29/7/2021,Sarawak,7253,9,117,126,0,53,53,2642,175,0
29/7/2021,Selangor,4536,0,424,424,0,331,331,2601,7,0
29/7/2021,Terengganu,2354,29,165,194,30,253,283,1312,138,0
29/7/2021,W.P. Labuan,345,1,15,16,4,3,7,75,19,0
30/7/2021,Johor,2833,0,268,268,0,319,319,2306,0,0
30/7/2021,Kedah,540,0,75,75,0,47,47,324,0,0
30/7/2021,Kelantan,2725,7,218,225,8,283,291,1713,56,0
30/7/2021,Melaka,1642,0,135,135,0,78,78,839,0,0
30/7/2021,Negeri Sembilan,2104,0,140,140,0,180,180,1086,0,0
30/7/2021,Pahang,3106,4,424,428,10,221,231,2564,44,0
30/7/2021,Perak,1341,0,102,102,0,112,112,1002,1,187
30/7/2021,Perlis,214,6,3,9,0,1,1,23,6,0
30/7/2021,Pulau Pinang,1871,0,163,163,0,162,162,901,0,0
30/7/2021,Sabah,5479,15,555,570,4,335,339,3131,127,0
30/7/2021,Sarawak,7253,4,132,136,1,68,69,2707,185,0
30/7/2021,Selangor,4536,0,350,350,0,241,241,2772,7,0
30/7/2021,Terengganu,2838,27,236,263,28,181,209,1367,144,0
30/7/2021,W.P. Labuan,345,5,7,12,3,0,3,67,19,0
31/7/2021,Johor,2833,0,297,297,0,285,285,2302,0,0
31/7/2021,Kedah,540,0,72,72,0,37,37,342,0,0
31/7/2021,Kelantan,2785,4,245,249,20,94,114,1864,40,0
31/7/2021,Melaka,1642,0,228,228,0,120,120,939,0,0
31/7/2021,Negeri Sembilan,2104,0,167,167,0,167,167,1074,0,0
31/7/2021,Pahang,3106,7,274,281,3,329,332,2465,49,0
31/7/2021,Perak,1302,0,117,117,0,81,81,986,4,176
31/7/2021,Perlis,214,9,18,27,0,1,1,40,14,0
31/7/2021,Pulau Pinang,1871,0,208,208,0,239,239,883,0,0
31/7/2021,Sabah,4764,27,590,617,15,471,486,3112,118,0
31/7/2021,Sarawak,7253,3,143,146,0,74,74,2780,174,0
31/7/2021,Selangor,4536,2,380,382,0,401,401,2778,5,0
31/7/2021,Terengganu,2838,83,586,669,38,262,300,1690,188,0
31/7/2021,W.P. Labuan,345,3,6,9,3,0,3,60,13,0
1/8/2021,Johor,2863,0,450,450,0,505,505,2271,0,0
1/8/2021,Kedah,540,0,81,81,0,46,46,360,0,0
1/8/2021,Kelantan,2615,7,237,244,2,230,232,1868,45,0
1/8/2021,Melaka,1642,0,193,193,0,132,132,1000,0,0
1/8/2021,Negeri Sembilan,2104,0,220,220,0,182,182,1097,0,0
1/8/2021,Pahang,3106,9,325,334,4,279,283,2801,54,0
1/8/2021,Perak,1302,0,91,91,0,100,100,958,3,182
1/8/2021,Perlis,214,2,11,13,0,0,0,48,12,0
1/8/2021,Pulau Pinang,1871,0,107,107,0,240,240,740,0,0
1/8/2021,Sabah,5068,16,643,659,17,548,565,3336,117,0
1/8/2021,Sarawak,7482,1,76,77,1,35,36,2835,175,0
1/8/2021,Selangor,4536,0,401,401,0,453,453,2749,9,0
1/8/2021,Terengganu,2838,35,206,241,71,304,375,1592,152,0
1/8/2021,W.P. Labuan,345,4,0,4,1,0,1,44,16,0
2/8/2021,Johor,2948,0,386,386,0,339,339,2306,0,0
2/8/2021,Kedah,540,0,53,53,0,44,44,354,0,0
2/8/2021,Kelantan,2757,12,222,234,11,344,355,1742,46,0
2/8/2021,Melaka,1642,0,245,245,0,156,156,1087,0,0
2/8/2021,Negeri Sembilan,2104,0,233,233,0,223,223,1098,0,0
2/8/2021,Pahang,3106,5,283,288,9,244,253,2825,50,0
2/8/2021,Perak,1411,0,87,87,0,184,184,851,4,177
2/8/2021,Perlis,214,1,2,3,0,7,7,43,12,0
2/8/2021,Pulau Pinang,1871,0,86,86,0,287,287,558,0,0
2/8/2021,Sabah,5222,20,622,642,6,541,547,3501,142,0
2/8/2021,Sarawak,7482,0,62,62,1,31,32,2741,188,0
2/8/2021,Selangor,4536,0,366,366,0,443,443,2735,7,0
2/8/2021,Terengganu,3230,26,329,355,28,284,312,1632,170,0
2/8/2021,W.P. Labuan,251,0,3,3,0,0,0,37,14,0
3/8/2021,Johor,2942,0,324,324,0,317,317,2313,0,0
3/8/2021,Kedah,540,0,52,52,0,65,65,342,0,0
3/8/2021,Kelantan,2757,11,222,233,9,209,218,1755,48,0
3/8/2021,Melaka,1642,0,262,262,0,110,110,1239,0,0
3/8/2021,Negeri Sembilan,2104,0,209,209,0,244,244,1024,0,0
3/8/2021,Pahang,3106,4,223,227,3,194,197,2822,50,0
3/8/2021,Perak,1372,0,188,188,0,110,110,909,4,181
3/8/2021,Perlis,214,2,4,6,11,5,16,42,2,0
3/8/2021,Sabah,4427,16,609,625,9,587,596,3519,141,0
3/8/2021,Sarawak,7652,2,95,97,0,73,73,2828,198,0
3/8/2021,Selangor,4536,0,275,275,0,319,319,2675,10,0
3/8/2021,Terengganu,3230,63,318,381,22,307,329,1805,219,0
3/8/2021,W.P. Labuan,230,0,1,1,2,0,2,34,10,0
4/8/2021,Johor,2942,0,350,350,0,555,555,2098,0,0
4/8/2021,Kedah,540,0,65,65,0,64,64,335,0,0
4/8/2021,Kelantan,2807,8,335,343,9,304,313,1786,47,0
4/8/2021,Melaka,1642,0,148,148,0,130,130,1257,0,0
4/8/2021,Negeri Sembilan,2104,0,179,179,0,110,110,1084,0,0
4/8/2021,Pahang,3106,7,267,274,14,395,409,2603,44,0
4/8/2021,Perak,1372,0,128,128,0,59,59,956,0,189
4/8/2021,Perlis,214,0,1,1,0,2,2,44,1,0
4/8/2021,Pulau Pinang,1871,0,86,86,0,294,294,504,0,0
4/8/2021,Sabah,4764,15,573,588,16,552,568,3507,140,0
4/8/2021,Sarawak,7512,3,32,35,1,57,58,2915,211,0
4/8/2021,Selangor,4536,2,418,420,0,426,426,2702,8,0
4/8/2021,Terengganu,3230,57,216,273,47,280,327,1617,219,0
4/8/2021,W.P. Labuan,251,14,0,14,2,0,2,42,3,14
5/8/2021,Johor,2942,0,504,504,0,463,463,2091,0,0
5/8/2021,Kedah,600,2,64,66,0,69,69,322,2,0
5/8/2021,Kelantan,2907,14,487,501,9,316,325,1954,52,0
5/8/2021,Melaka,1642,0,118,118,0,187,187,1188,0,0
5/8/2021,Negeri Sembilan,2104,0,207,207,0,124,124,1156,0,0
5/8/2021,Pahang,3106,8,228,236,6,352,358,2648,54,0
5/8/2021,Perak,1411,0,295,295,0,266,266,966,0,176
5/8/2021,Perlis,214,1,0,1,0,0,0,45,1,0
5/8/2021,Pulau Pinang,1851,0,73,73,0,100,100,433,0,0
5/8/2021,Sabah,5467,20,537,557,5,558,563,3451,125,0
5/8/2021,Sarawak,7456,1,142,143,0,100,100,2594,213,0
5/8/2021,Selangor,4536,2,422,424,0,422,422,2760,11,0
5/8/2021,Terengganu,3230,57,345,402,47,342,389,1621,229,0
5/8/2021,W.P. Labuan,251,0,11,11,0,1,1,46,15,0
6/8/2021,Johor,2942,0,480,480,0,331,331,2234,0,0
6/8/2021,Kedah,600,0,52,52,0,69,69,312,0,0
6/8/2021,Kelantan,2977,21,550,571,5,318,323,2127,53,0
6/8/2021,Melaka,1642,0,122,122,0,203,203,1107,0,0
6/8/2021,Negeri Sembilan,2104,0,194,194,0,167,167,1165,0,0
6/8/2021,Pahang,3106,7,273,280,8,274,282,2616,44,0
6/8/2021,Perak,1411,0,137,137,0,111,111,977,0,175
6/8/2021,Perlis,214,7,5,12,0,5,5,44,6,0
6/8/2021,Pulau Pinang,1871,0,86,86,0,100,100,433,0,0
6/8/2021,Sabah,5467,27,609,636,9,594,603,3346,136,0
6/8/2021,Sarawak,7196,2,84,86,4,78,82,2740,213,0
6/8/2021,Selangor,4536,3,503,506,0,394,394,2911,10,0
6/8/2021,Terengganu,3230,21,251,272,20,251,271,1623,231,0
6/8/2021,W.P. Labuan,251,0,8,8,5,0,5,50,4,0
7/8/2021,Johor,2942,0,430,430,0,291,291,2322,0,0
7/8/2021,Kedah,600,0,100,100,0,64,64,328,0,0
7/8/2021,Kelantan,3097,5,328,333,14,238,252,2272,61,0
7/8/2021,Melaka,1642,0,123,123,0,200,200,1030,0,0
7/8/2021,Negeri Sembilan,2104,0,171,171,0,198,198,1129,0,0
7/8/2021,Pahang,3106,9,292,301,9,382,391,2523,44,0
7/8/2021,Perak,1372,0,129,129,0,104,104,978,5,161
7/8/2021,Perlis,214,2,24,26,0,9,9,59,3,0
7/8/2021,Pulau Pinang,1871,0,111,111,0,57,57,471,0,0
7/8/2021,Sabah,5467,15,619,634,10,558,568,3356,152,0
7/8/2021,Sarawak,7196,3,113,116,2,88,90,2841,214,0
7/8/2021,Selangor,4536,0,422,422,0,342,342,2942,12,0
7/8/2021,Terengganu,3230,60,440,500,42,364,406,1696,249,0
7/8/2021,W.P. Labuan,251,0,0,0,1,0,1,43,8,0
8/8/2021,Johor,2942,0,298,298,0,335,335,2283,0,0
8/8/2021,Kedah,600,0,89,89,0,48,48,361,0,0
8/8/2021,Kelantan,3097,3,418,421,8,207,215,2483,56,0
8/8/2021,Melaka,1642,0,185,185,0,188,188,1027,0,0
8/8/2021,Negeri Sembilan,2104,0,176,176,0,204,204,1097,0,0
8/8/2021,Pahang,3173,14,279,293,1,441,442,2352,58,0
8/8/2021,Perak,1372,0,170,170,0,131,131,1007,0,174
8/8/2021,Perlis,214,0,3,3,0,4,4,58,0,0
8/8/2021,Pulau Pinang,1871,0,111,111,0,57,57,471,0,0
8/8/2021,Sabah,5667,168,646,814,25,615,640,3442,265,0
8/8/2021,Sarawak,7196,4,96,100,0,78,78,2953,227,0
8/8/2021,Selangor,4556,1,455,456,1,466,467,2952,9,0
8/8/2021,Terengganu,3230,46,253,299,77,288,365,1661,218,0
8/8/2021,W.P. Labuan,251,0,2,2,3,0,3,37,5,0
9/8/2021,Johor,2942,0,391,391,0,350,350,2323,0,0
9/8/2021,Kedah,600,0,89,89,0,48,48,361,0,0
9/8/2021,Kelantan,3097,3,280,283,8,221,229,2538,51,1
9/8/2021,Melaka,1642,0,161,161,0,230,230,1041,0,0
9/8/2021,Negeri Sembilan,2104,0,148,148,0,208,208,1030,0,0
9/8/2021,Pahang,3173,5,295,300,3,215,218,2413,60,0
9/8/2021,Perak,1377,0,214,214,0,178,178,1019,5,191
9/8/2021,Perlis,214,6,1,7,0,7,7,52,6,0
9/8/2021,Pulau Pinang,1871,0,209,209,0,81,81,649,0,0
9/8/2021,Sabah,5625,22,640,662,11,562,573,3488,134,0
9/8/2021,Sarawak,7196,3,162,165,1,131,132,2939,225,15
9/8/2021,Selangor,4556,4,433,437,2,485,487,3079,11,0
9/8/2021,Terengganu,3230,35,370,405,33,186,219,1845,220,0
9/8/2021,W.P. Labuan,251,0,2,2,0,0,0,34,5,0
10/8/2021,Johor,2942,0,567,567,0,278,278,2597,0,0
10/8/2021,Kedah,600,0,78,78,0,44,44,396,0,0
10/8/2021,Kelantan,3211,5,291,296,7,234,241,2595,49,1
10/8/2021,Melaka,1642,0,125,125,0,179,179,919,0,0
10/8/2021,Negeri Sembilan,2104,0,138,138,0,0,0,904,0,0
10/8/2021,Pahang,3173,3,284,287,10,287,297,2420,53,0
10/8/2021,Perak,1377,0,106,106,0,83,83,1030,0,182
10/8/2021,Perlis,214,5,18,23,0,5,5,68,5,0
10/8/2021,Pulau Pinang,1871,0,209,209,0,81,81,649,0,0
10/8/2021,Sabah,5598,20,592,612,13,639,652,3422,123,0
10/8/2021,Sarawak,7401,4,123,127,6,123,129,3008,388,0
10/8/2021,Selangor,4556,1,392,393,0,477,477,2996,9,0
10/8/2021,Terengganu,3230,46,299,345,90,312,402,1833,176,0
10/8/2021,W.P. Labuan,251,9,1,10,0,0,0,43,14,0
11/8/2021,Johor,2942,0,362,362,0,292,292,2619,0,0
11/8/2021,Kedah,600,0,76,76,0,65,65,400,0,0
11/8/2021,Kelantan,3381,5,231,236,6,321,327,2460,48,0
11/8/2021,Melaka,1642,0,174,174,0,119,119,948,0,0
11/8/2021,Negeri Sembilan,2104,0,96,96,0,99,99,893,0,0
11/8/2021,Pahang,3173,0,377,377,1,329,330,2477,56,0
11/8/2021,Perak,1377,0,125,125,0,176,176,963,1,184
11/8/2021,Perlis,214,0,8,8,0,2,2,74,1,0
11/8/2021,Pulau Pinang,2051,0,235,235,0,98,98,650,0,0
11/8/2021,Sabah,5955,29,633,662,15,621,636,3583,148,0
11/8/2021,Sarawak,7501,5,95,100,1,157,158,3192,255,0
11/8/2021,Selangor,4556,0,423,423,0,365,365,3108,9,0
11/8/2021,Terengganu,3230,42,256,298,58,389,447,1700,160,0
11/8/2021,W.P. Labuan,475,8,1,9,0,0,0,29,22,0
12/8/2021,Johor,3442,0,502,502,0,445,445,2657,0,0
12/8/2021,Kedah,600,0,57,57,0,55,55,389,0,0
12/8/2021,Kelantan,3381,4,182,186,15,539,554,2103,37,0
12/8/2021,Melaka,1642,0,163,163,0,0,0,976,0,0
12/8/2021,Negeri Sembilan,2104,0,157,157,0,132,132,813,0,0
12/8/2021,Pahang,3438,8,368,376,1,272,273,2606,63,0
12/8/2021,Perak,1344,0,120,120,0,141,141,892,1,153
12/8/2021,Perlis,214,2,14,16,0,0,0,97,2,0
12/8/2021,Pulau Pinang,2051,0,218,218,0,78,78,680,0,0
12/8/2021,Sabah,5955,19,698,717,12,451,463,3789,136,0
12/8/2021,Sarawak,7534,6,102,108,0,166,166,3212,250,0
12/8/2021,Selangor,4556,2,488,490,0,404,404,3150,6,0
12/8/2021,Terengganu,3230,85,335,420,35,424,459,1610,205,0
12/8/2021,W.P. Labuan,475,0,0,0,1,2,3,37,10,0
13/8/2021,Johor,3442,4,430,434,0,443,443,2552,1,7
13/8/2021,Kedah,540,0,91,91,0,83,83,384,0,0
13/8/2021,Kelantan,3381,19,334,353,9,387,396,2011,41,1
13/8/2021,Melaka,1642,0,137,137,0,149,149,624,0,0
13/8/2021,Negeri Sembilan,2104,0,149,149,0,161,161,896,0,0
13/8/2021,Pahang,3438,3,336,339,8,206,214,2688,52,0
13/8/2021,Perak,1207,0,93,93,0,109,109,760,0,96
13/8/2021,Perlis,214,7,27,34,0,18,18,105,8,0
13/8/2021,Pulau Pinang,2051,0,218,218,0,78,78,678,0,0
13/8/2021,Sabah,5955,28,727,755,9,493,502,3986,164,0
13/8/2021,Sarawak,7017,3,106,109,2,119,121,3148,262,0
13/8/2021,Selangor,4556,3,633,636,0,544,544,3312,7,0
13/8/2021,Terengganu,3230,25,356,381,49,297,346,1670,207,0
13/8/2021,W.P. Labuan,475,1,4,5,1,0,1,26,8,0
14/8/2021,Johor,1942,5,229,234,3,215,218,1434,10,0
14/8/2021,Kedah,600,0,54,54,0,30,30,349,0,0
14/8/2021,Kelantan,3381,8,364,372,8,446,454,2029,41,1
14/8/2021,Melaka,1642,0,176,176,0,141,141,999,0,0
14/8/2021,Negeri Sembilan,2104,0,108,108,0,164,164,835,0,0
14/8/2021,Pahang,3438,6,249,255,9,185,194,2536,49,0
14/8/2021,Perak,1207,0,77,77,0,83,83,666,0,92
14/8/2021,Perlis,214,3,24,27,0,14,14,114,4,0
14/8/2021,Pulau Pinang,2051,0,116,116,0,87,87,716,0,0
14/8/2021,Sabah,5955,49,683,732,9,573,582,4020,165,0
14/8/2021,Sarawak,7084,15,136,151,2,110,112,3258,307,0
14/8/2021,Selangor,4556,2,491,493,1,424,425,3357,8,0
14/8/2021,Terengganu,3230,51,307,358,41,261,302,1716,215,0
14/8/2021,W.P. Labuan,475,5,0,5,1,0,1,25,9,0
15/8/2021,Johor,1942,4,293,297,3,212,215,1504,9,0
15/8/2021,Kedah,1026,0,102,102,0,75,75,373,0,0
15/8/2021,Kelantan,3381,4,248,252,2,346,348,1948,40,0
15/8/2021,Melaka,1642,0,147,147,0,123,123,1017,0,0
15/8/2021,Negeri Sembilan,2104,0,186,186,0,155,155,862,0,0
15/8/2021,Pahang,3438,6,263,269,9,120,129,2566,49,0
15/8/2021,Perak,1207,0,130,130,0,102,102,657,0,102
15/8/2021,Perlis,214,3,7,10,0,12,12,123,3,0
15/8/2021,Pulau Pinang,2051,0,165,165,0,89,89,202,0,0
15/8/2021,Sabah,5955,11,674,685,32,532,564,4119,180,0
15/8/2021,Sarawak,7221,4,162,166,0,118,118,3392,280,0
15/8/2021,Selangor,4556,1,531,532,0,564,564,3289,7,0
15/8/2021,Terengganu,3230,29,284,313,36,313,349,1686,214,0
15/8/2021,W.P. Labuan,475,0,3,3,1,0,1,27,5,0
16/8/2021,Johor,3142,3,227,230,2,400,402,2458,12,0
16/8/2021,Kedah,1026,0,86,86,0,57,57,394,0,0
16/8/2021,Kelantan,3381,3,367,370,3,365,368,1935,40,0
16/8/2021,Negeri Sembilan,2104,0,189,189,0,160,160,887,0,0
16/8/2021,Pahang,3438,4,392,396,3,211,214,3110,71,0
16/8/2021,Perak,687,6,27,33,0,66,66,213,6,95
16/8/2021,Perlis,214,4,4,8,0,12,12,117,7,0
16/8/2021,Pulau Pinang,1861,0,181,181,0,140,140,810,0,0
16/8/2021,Sabah,5955,24,659,683,11,522,533,3942,260,0
16/8/2021,Sarawak,7631,0,83,83,0,52,52,3374,294,0
16/8/2021,Selangor,4556,0,445,445,1,457,458,3192,6,0
16/8/2021,Terengganu,3230,38,273,311,46,257,303,1701,206,0
16/8/2021,W.P. Labuan,475,2,2,4,1,1,2,29,6,0
17/8/2021,Johor,1642,4,264,268,2,266,268,1295,14,0
17/8/2021,Kedah,1026,0,63,63,0,69,69,387,0,0
17/8/2021,Kelantan,3381,24,380,404,3,209,212,2139,42,0
17/8/2021,Melaka,1642,0,151,151,0,167,167,924,0,0
17/8/2021,Negeri Sembilan,2104,0,96,96,0,158,158,822,0,0
17/8/2021,Pahang,3398,15,447,462,0,362,362,2944,70,0
17/8/2021,Perak,1367,0,144,144,0,32,32,618,0,86
17/8/2021,Perlis,214,0,9,9,0,15,15,119,4,0
17/8/2021,Pulau Pinang,1861,0,160,160,0,142,142,750,0,0
17/8/2021,Sabah,5725,17,527,544,6,440,446,3934,185,0
17/8/2021,Sarawak,7631,4,175,179,5,223,228,3398,283,0
17/8/2021,Selangor,4556,12,341,353,1,514,515,3113,6,0
17/8/2021,Terengganu,3230,37,319,356,36,243,279,1780,199,0
17/8/2021,W.P. Labuan,345,0,0,0,0,0,0,0,0,0
18/8/2021,Johor,1942,0,296,296,1,260,261,1480,13,0
18/8/2021,Kedah,1026,0,77,77,0,51,51,403,0,0
18/8/2021,Kelantan,3381,1,290,291,8,214,222,2229,36,0
18/8/2021,Melaka,1642,0,146,146,0,141,141,929,0,0
18/8/2021,Negeri Sembilan,2104,0,157,157,0,73,73,901,0,0
18/8/2021,Pahang,3648,14,416,430,5,346,351,3246,55,0
18/8/2021,Perak,1367,3,146,149,0,9,9,712,3,112
18/8/2021,Perlis,214,0,7,7,0,101,101,105,7,0
18/8/2021,Pulau Pinang,1861,0,116,116,0,127,127,802,0,0
18/8/2021,Sabah,5724,9,552,561,9,419,428,4003,180,0
18/8/2021,Sarawak,7821,7,109,116,5,108,113,3301,283,0
18/8/2021,Selangor,4556,1,488,489,0,473,473,3078,8,0
18/8/2021,Terengganu,3230,33,351,384,62,333,395,1795,171,0
18/8/2021,W.P. Labuan,475,0,0,0,0,1,1,30,7,0
19/8/2021,Johor,2456,2,281,283,1,388,389,1629,13,0
19/8/2021,Kedah,1026,0,76,76,0,69,69,411,0,0
19/8/2021,Kelantan,3404,4,274,278,2,230,232,2270,38,0
19/8/2021,Melaka,1642,0,111,111,0,144,144,896,0,0
19/8/2021,Negeri Sembilan,2104,0,86,86,0,135,135,845,0,0
19/8/2021,Pahang,3648,6,323,329,9,339,348,2984,23,0
19/8/2021,Perak,1370,0,116,116,0,31,31,746,0,97
19/8/2021,Perlis,232,3,31,34,0,13,13,125,5,0
19/8/2021,Pulau Pinang,1628,0,128,128,0,133,133,658,0,0
19/8/2021,Sabah,5124,11,509,520,15,644,659,3886,231,0
19/8/2021,Sarawak,7671,6,161,167,2,127,129,3319,310,0
19/8/2021,Selangor,4556,0,447,447,0,538,538,3118,6,0
19/8/2021,Terengganu,3230,59,292,351,35,349,384,1425,168,0
19/8/2021,W.P. Labuan,441,0,2,2,0,0,0,24,7,0
20/8/2021,Johor,2456,0,342,342,6,281,287,1679,7,0
20/8/2021,Kedah,1026,0,74,74,0,60,60,425,0,0
20/8/2021,Kelantan,3361,4,335,339,0,209,209,2410,40,0
20/8/2021,Melaka,1642,0,92,92,0,109,109,872,0,0
20/8/2021,Negeri Sembilan,2104,0,184,184,0,139,139,884,0,0
20/8/2021,Pahang,3648,8,498,506,2,324,326,3451,24,0
20/8/2021,Perak,1330,0,97,97,0,44,44,745,0,93
20/8/2021,Perlis,232,2,6,8,0,15,15,123,7,0
20/8/2021,Pulau Pinang,1628,0,180,180,0,152,152,756,0,0
20/8/2021,Sabah,5112,27,448,475,18,508,526,3740,172,0
20/8/2021,Sarawak,7671,1,95,96,1,124,125,3447,287,0
20/8/2021,Selangor,4556,0,482,482,0,668,668,2971,4,0
20/8/2021,Terengganu,3230,65,317,382,39,299,338,1633,220,126
20/8/2021,W.P. Labuan,475,6,1,7,1,0,1,18,12,0
21/8/2021,Johor,2456,0,306,306,1,289,290,1687,6,0
21/8/2021,Kedah,1026,0,47,47,0,73,73,394,0,0
21/8/2021,Kelantan,3361,5,255,260,4,257,261,2430,33,0
21/8/2021,Melaka,1642,0,130,130,0,154,154,843,0,0
21/8/2021,Negeri Sembilan,2104,0,125,125,0,131,131,874,0,0
21/8/2021,Pahang,3648,5,289,294,3,277,280,3477,69,0
21/8/2021,Perak,1290,0,144,144,0,51,51,757,0,110
21/8/2021,Perlis,232,2,49,51,0,28,28,162,8,0
21/8/2021,Pulau Pinang,1628,0,125,125,0,119,119,762,0,0
21/8/2021,Sabah,5345,20,1187,1207,9,530,539,3699,174,0
21/8/2021,Sarawak,7671,2,64,66,3,84,87,3334,291,0
21/8/2021,Selangor,4556,2,490,492,2,523,525,2907,5,0
21/8/2021,Terengganu,3230,53,336,389,56,300,356,1794,217,0
21/8/2021,W.P. Labuan,475,0,1,1,0,0,0,23,6,0
22/8/2021,Johor,3517,2,429,431,2,363,365,2684,6,0
22/8/2021,Kedah,1026,0,76,76,0,83,83,374,0,0
22/8/2021,Kelantan,3361,3,255,258,1,292,293,2397,35,0
22/8/2021,Melaka,1642,0,122,122,0,0,0,834,0,0
22/8/2021,Negeri Sembilan,2104,0,76,76,0,150,150,794,0,0
22/8/2021,Pahang,3648,10,320,330,6,299,305,3524,68,0
22/8/2021,Perak,1330,0,63,63,0,21,21,762,0,99
22/8/2021,Perlis,232,7,6,13,0,9,9,157,16,0
22/8/2021,Pulau Pinang,1628,0,143,143,0,140,140,712,0,0
22/8/2021,Sabah,5345,26,361,387,8,568,576,3521,183,0
22/8/2021,Sarawak,7415,5,122,127,2,164,166,3038,348,0
22/8/2021,Selangor,4556,2,420,422,126,488,614,2768,11,0
22/8/2021,Terengganu,3230,47,290,337,38,331,369,1733,226,0
22/8/2021,W.P. Labuan,475,6,3,9,0,0,0,23,12,0
23/8/2021,Johor,3467,0,294,294,4,286,290,2638,2,0
23/8/2021,Kedah,1026,0,77,77,0,58,58,392,0,0
23/8/2021,Kelantan,3011,5,253,258,2,439,441,2003,29,0
23/8/2021,Melaka,1642,0,101,101,0,136,136,799,0,0
23/8/2021,Negeri Sembilan,2104,0,90,90,0,144,144,737,0,0
23/8/2021,Pahang,3883,9,255,264,6,272,278,3484,61,0
23/8/2021,Perak,1330,0,103,103,0,25,25,765,0,116
23/8/2021,Perlis,232,3,17,20,0,7,7,173,26,0
23/8/2021,Pulau Pinang,1628,0,70,70,0,121,121,619,0,0
23/8/2021,Sabah,5299,45,484,529,4,513,517,3419,207,0
23/8/2021,Sarawak,7974,3,144,147,1,126,127,3474,396,0
23/8/2021,Selangor,4556,1,378,379,0,414,414,2695,69,0
23/8/2021,Terengganu,3230,37,342,379,50,287,337,1788,213,0
23/8/2021,W.P. Labuan,475,0,8,8,0,0,0,30,10,0
24/8/2021,Johor,3447,1,437,438,0,429,429,2587,3,0
24/8/2021,Kedah,1026,0,72,72,0,71,71,392,0,0
24/8/2021,Kelantan,3261,3,281,284,1,295,296,2242,32,0
24/8/2021,Melaka,1642,0,102,102,0,81,81,815,0,0
24/8/2021,Negeri Sembilan,2104,0,69,69,0,123,123,677,0,0
24/8/2021,Pahang,3883,9,269,278,5,316,321,3401,70,0
24/8/2021,Perak,1330,0,88,88,0,3,3,757,0,97
24/8/2021,Perlis,232,3,26,29,0,25,25,177,1,0
24/8/2021,Pulau Pinang,1644,0,72,72,0,102,102,657,0,0
24/8/2021,Sabah,5299,15,432,447,42,526,568,3317,182,0
24/8/2021,Sarawak,7562,0,94,94,0,115,115,3570,372,0
24/8/2021,Selangor,4506,5,385,390,1,478,479,2616,12,0
24/8/2021,Terengganu,3230,40,311,351,36,247,283,1852,217,0
24/8/2021,W.P. Labuan,475,0,3,3,0,0,0,31,7,0
25/8/2021,Johor,2156,2,331,333,1,320,321,1591,4,0
25/8/2021,Kedah,1026,0,68,68,0,76,76,376,0,0
25/8/2021,Kelantan,3261,1,309,310,7,423,430,2148,26,0
25/8/2021,Melaka,1642,0,0,0,0,0,0,804,0,0
25/8/2021,Negeri Sembilan,2104,0,53,53,0,53,53,658,0,0
25/8/2021,Pahang,3883,14,211,225,3,500,503,3496,78,0
25/8/2021,Perak,1330,0,95,95,0,3,3,767,0,86
25/8/2021,Perlis,232,2,28,30,0,22,22,192,3,0
25/8/2021,Pulau Pinang,1644,0,138,138,0,103,103,653,0,0
25/8/2021,Sabah,5299,14,485,499,3,424,427,3350,169,0
25/8/2021,Sarawak,7326,2,151,153,6,168,174,3831,424,0
25/8/2021,Selangor,4506,2,456,458,0,476,476,2626,56,0
25/8/2021,Terengganu,3230,40,200,240,69,284,353,1768,189,0
25/8/2021,W.P. Labuan,475,0,2,2,1,0,1,36,6,0
26/8/2021,Johor,3447,1,543,544,0,383,383,2688,5,0
26/8/2021,Kedah,1026,0,104,104,0,55,55,411,0,0
26/8/2021,Kelantan,3261,4,321,325,3,409,412,2087,28,0
26/8/2021,Melaka,1642,0,72,72,0,122,122,757,0,0
26/8/2021,Negeri Sembilan,2104,0,113,113,0,16,16,695,0,0
26/8/2021,Pahang,4265,6,314,320,9,460,469,3170,72,0
26/8/2021,Perak,1330,0,115,115,0,38,38,772,0,107
26/8/2021,Perlis,232,3,14,17,0,13,13,199,3,0
26/8/2021,Pulau Pinang,1644,0,138,138,0,92,92,641,0,0
26/8/2021,Sabah,5299,57,585,642,9,502,511,3439,203,0
26/8/2021,Sarawak,7681,3,114,117,1,153,154,3992,450,0
26/8/2021,Selangor,4446,0,489,489,1,404,405,2758,8,0
26/8/2021,Terengganu,3559,49,316,365,40,307,347,1777,198,0
26/8/2021,W.P. Labuan,475,5,3,8,1,0,1,33,10,0
27/8/2021,Johor,3539,3,595,598,1,425,426,2880,7,16
27/8/2021,Kedah,1026,0,124,124,0,75,75,455,0,0
27/8/2021,Kelantan,3341,7,283,290,4,297,301,2075,30,0
27/8/2021,Melaka,1642,0,105,105,0,103,103,759,0,0
27/8/2021,Negeri Sembilan,2104,0,104,104,0,153,153,641,0,0
27/8/2021,Pahang,4265,10,304,314,9,481,490,3015,74,0
27/8/2021,Perak,1298,0,146,146,0,6,6,736,0,69
27/8/2021,Perlis,232,4,26,30,0,24,24,214,5,0
27/8/2021,Pulau Pinang,1644,0,114,114,0,120,120,656,0,0
27/8/2021,Sabah,5299,48,530,578,49,445,494,3461,204,0
27/8/2021,Sarawak,7741,4,230,234,1,175,176,4338,486,0
27/8/2021,Selangor,4446,2,477,479,8,479,487,2817,70,0
27/8/2021,Terengganu,3559,73,368,441,50,308,358,1837,222,0
27/8/2021,W.P. Labuan,475,2,0,2,0,0,0,31,12,0
28/8/2021,Johor,3542,1,447,448,2,402,404,2931,6,5
28/8/2021,Kedah,1026,0,56,56,0,62,62,440,0,0
28/8/2021,Kelantan,3091,5,269,274,3,313,316,2078,34,0
28/8/2021,Melaka,1642,0,97,97,0,0,0,733,0,0
28/8/2021,Negeri Sembilan,2104,0,125,125,0,177,177,585,0,0
28/8/2021,Pahang,4265,25,273,298,3,311,314,3303,77,0
28/8/2021,Perak,1430,0,182,182,0,49,49,849,0,90
28/8/2021,Perlis,232,1,9,10,0,21,21,214,2,0
28/8/2021,Pulau Pinang,1424,0,124,124,0,122,122,505,0,0
28/8/2021,Sabah,5159,21,518,539,6,481,487,3438,212,0
28/8/2021,Sarawak,7741,2,157,159,0,189,189,4763,604,0
28/8/2021,Selangor,4446,4,471,475,1,464,465,2858,0,0
28/8/2021,Terengganu,3559,37,237,274,40,249,289,1805,219,0
28/8/2021,W.P. Labuan,475,0,6,6,0,0,0,36,4,0
29/8/2021,Johor,3554,0,531,531,4,480,484,2974,2,5
29/8/2021,Kedah,1026,0,81,81,0,71,71,438,0,0
29/8/2021,Kelantan,3091,3,261,264,6,265,271,2104,31,0
29/8/2021,Melaka,1642,0,57,57,0,84,84,706,0,0
29/8/2021,Negeri Sembilan,2104,0,75,75,0,75,75,581,0,0
29/8/2021,Pahang,4265,95,229,324,9,335,344,3038,83,0
29/8/2021,Perak,1430,1,68,69,0,91,91,785,1,99
29/8/2021,Perlis,232,1,4,5,0,19,19,208,3,0
29/8/2021,Pulau Pinang,1644,0,0,0,0,0,0,716,0,0
29/8/2021,Sabah,5249,16,391,407,4,411,415,3507,206,0
29/8/2021,Sarawak,7741,0,218,218,0,129,129,4960,628,0
29/8/2021,Selangor,4446,0,587,587,0,438,438,2975,12,0
29/8/2021,Terengganu,3559,44,190,234,49,296,345,1699,214,0
29/8/2021,W.P. Labuan,475,5,0,5,0,0,0,34,9,0
30/8/2021,Johor,3585,2,521,523,1,433,434,3052,3,6
30/8/2021,Kedah,1026,0,68,68,0,86,86,406,0,0
30/8/2021,Kelantan,3091,2,311,313,3,204,207,2221,30,0
30/8/2021,Melaka,1642,0,115,115,0,99,99,722,0,0
30/8/2021,Negeri Sembilan,2104,0,73,73,0,107,107,546,0,0
30/8/2021,Pahang,4265,4,299,303,4,404,408,2961,79,0
30/8/2021,Perak,1430,0,153,153,0,54,54,836,0,94
30/8/2021,Perlis,232,6,10,16,0,16,16,222,10,0
30/8/2021,Pulau Pinang,1865,0,154,154,0,149,149,823,0,0
30/8/2021,Sabah,5249,25,423,448,10,515,525,3419,181,0
30/8/2021,Sarawak,8537,6,136,142,0,106,106,5103,638,0
30/8/2021,Selangor,4446,0,379,379,1,423,424,2949,10,0
30/8/2021,Terengganu,3559,37,311,348,42,295,337,1715,209,0
30/8/2021,W.P. Labuan,475,0,3,3,1,0,1,32,6,0
31/8/2021,Johor,2385,0,384,384,1,306,307,2021,2,2
31/8/2021,Kedah,826,0,62,62,0,60,60,395,0,0
31/8/2021,Kelantan,3069,5,250,255,3,203,206,2253,29,0
31/8/2021,Melaka,1642,0,110,110,0,75,75,757,0,0
31/8/2021,Negeri Sembilan,2104,0,72,72,0,87,87,540,0,0
31/8/2021,Pahang,4265,7,383,390,5,289,294,2683,438,0
31/8/2021,Perak,1430,0,130,130,0,29,29,852,0,101
31/8/2021,Perlis,232,0,7,7,0,21,21,207,3,0
31/8/2021,Pulau Pinang,1865,0,130,130,0,123,123,804,0,0
31/8/2021,Sabah,5249,11,360,371,4,462,466,3349,205,0
31/8/2021,Sarawak,8667,2,108,110,2,138,140,5274,629,0
31/8/2021,Selangor,4124,2,364,366,0,447,447,2897,0,0
31/8/2021,Terengganu,3559,49,263,312,31,247,278,1731,227,0
31/8/2021,W.P. Labuan,475,5,3,8,0,0,0,27,11,0
1/9/2021,Johor,2371,0,381,381,0,321,321,2071,2,2
1/9/2021,Kedah,826,0,88,88,0,66,66,415,0,0
1/9/2021,Kelantan,3069,2,313,315,3,269,272,2288,26,0
1/9/2021,Melaka,1642,0,96,96,0,67,67,786,0,0
1/9/2021,Negeri Sembilan,2104,0,66,66,0,38,38,566,0,0
1/9/2021,Pahang,4265,12,325,337,5,281,286,3080,87,0
1/9/2021,Perak,1430,0,57,57,0,5,5,815,0,117
1/9/2021,Perlis,244,0,1,1,0,17,17,192,3,0
1/9/2021,Pulau Pinang,1865,0,104,104,0,96,96,796,0,0
1/9/2021,Sabah,5249,23,374,397,15,406,421,3334,202,0
1/9/2021,Sarawak,8937,6,139,145,1,115,116,5476,708,0
1/9/2021,Selangor,4124,7,529,536,2,429,431,3001,12,0
1/9/2021,Terengganu,3328,28,340,368,43,359,402,1712,212,0
1/9/2021,W.P. Labuan,475,0,3,3,0,0,0,26,11,0
2/9/2021,Johor,2352,0,417,417,1,383,384,2097,1,2
2/9/2021,Kedah,826,0,73,73,0,75,75,404,0,0
2/9/2021,Kelantan,3069,1,325,326,6,369,375,2213,21,0
2/9/2021,Melaka,1642,0,65,65,0,2,2,766,0,0
2/9/2021,Negeri Sembilan,2104,0,105,105,0,64,64,605,0,0
2/9/2021,Pahang,4265,4,248,252,11,320,331,2831,84,0
2/9/2021,Perak,1444,0,138,138,0,6,6,830,0,111
2/9/2021,Perlis,244,2,0,2,0,18,18,165,2,0
2/9/2021,Pulau Pinang,1865,0,112,112,0,116,116,756,0,0
2/9/2021,Sabah,5249,15,395,410,8,404,412,3335,167,0
2/9/2021,Sarawak,9077,2,129,131,1,211,212,5486,761,0
2/9/2021,Selangor,4124,3,399,402,0,373,373,3048,22,0
2/9/2021,Terengganu,3281,43,289,332,46,340,386,1661,209,0
2/9/2021,W.P. Labuan,475,0,4,4,1,0,1,30,8,0
3/9/2021,Johor,2352,0,327,327,1,359,360,2061,0,2
3/9/2021,Kedah,826,0,88,88,0,79,79,415,0,0
3/9/2021,Kelantan,3167,3,276,279,6,337,343,2123,17,0
3/9/2021,Melaka,1642,0,129,129,0,59,59,836,0,0
3/9/2021,Negeri Sembilan,2104,0,46,46,0,121,121,527,0,0
3/9/2021,Pahang,4265,54,273,327,10,291,301,3003,91,0
3/9/2021,Perak,1444,0,67,67,0,58,58,779,0,113
3/9/2021,Perlis,244,2,4,6,0,26,26,159,8,0
3/9/2021,Pulau Pinang,1865,0,97,97,0,135,135,776,0,0
3/9/2021,Sabah,5189,6,440,446,12,525,537,3185,162,0
3/9/2021,Sarawak,9195,3,209,212,2,236,238,5383,881,0
3/9/2021,Selangor,4124,1,470,471,0,496,496,2665,0,0
3/9/2021,Terengganu,3281,38,386,424,50,332,382,1715,197,0
3/9/2021,W.P. Labuan,475,5,4,9,1,0,1,25,12,0
4/9/2021,Johor,2330,2,253,255,0,335,335,1967,4,1
4/9/2021,Kedah,826,0,108,108,0,79,79,434,0,0
4/9/2021,Kelantan,3167,4,337,341,16,265,281,2168,21,0
4/9/2021,Melaka,1642,0,85,85,0,48,48,866,0,0
4/9/2021,Negeri Sembilan,2104,0,45,45,0,84,84,507,0,0
4/9/2021,Pahang,2969,29,150,179,5,221,226,2218,111,0
4/9/2021,Perak,1444,0,177,177,0,8,8,845,0,107
4/9/2021,Perlis,244,0,4,4,0,12,12,171,2,0
4/9/2021,Pulau Pinang,1865,0,90,90,0,135,135,745,0,0
4/9/2021,Sabah,5289,8,397,405,24,497,521,2980,152,0
4/9/2021,Sarawak,9270,5,122,127,2,290,292,5788,679,0
4/9/2021,Selangor,4124,5,442,447,0,510,510,2973,19,0
4/9/2021,Terengganu,3185,46,351,397,37,300,337,1766,206,0
4/9/2021,W.P. Labuan,251,0,3,3,0,0,0,26,6,0
5/9/2021,Johor,2330,1,230,231,0,330,330,1857,5,0
5/9/2021,Kedah,826,0,71,71,0,31,31,475,0,0
5/9/2021,Kelantan,3167,3,307,310,0,322,322,2119,22,0
5/9/2021,Melaka,1501,0,57,57,0,54,54,869,0,0
5/9/2021,Negeri Sembilan,2104,0,68,68,0,78,78,493,0,0
5/9/2021,Pahang,4265,4,241,245,8,275,283,3061,115,0
5/9/2021,Perak,1444,0,104,104,0,147,147,755,0,105
5/9/2021,Perlis,244,1,10,11,0,62,62,129,5,0
5/9/2021,Pulau Pinang,1895,0,126,126,0,121,121,711,0,0
5/9/2021,Sabah,5319,15,434,449,7,453,460,3018,136,0
5/9/2021,Sarawak,9550,3,247,250,1,142,143,5870,722,0
5/9/2021,Selangor,4124,1,506,507,5,526,531,2980,11,0
5/9/2021,Terengganu,3281,41,291,332,49,233,282,1773,198,0
5/9/2021,W.P. Labuan,251,5,3,8,0,0,0,27,11,0
6/9/2021,Johor,2315,0,260,260,1,351,352,1756,4,1
6/9/2021,Kedah,826,0,61,61,0,69,69,425,0,0
6/9/2021,Kelantan,3167,1,271,272,6,301,307,2090,18,0
6/9/2021,Melaka,1501,0,74,74,0,77,77,866,0,0
6/9/2021,Negeri Sembilan,2104,0,68,68,0,89,89,471,0,0
6/9/2021,Pahang,4265,6,203,209,8,326,334,2884,93,0
6/9/2021,Perak,1444,0,94,94,0,14,14,743,0,108
6/9/2021,Perlis,214,1,7,8,0,13,13,125,4,0
6/9/2021,Pulau Pinang,1895,0,105,105,0,126,126,706,0,0
6/9/2021,Sabah,5289,9,393,402,31,411,442,2969,109,0
6/9/2021,Sarawak,9650,8,197,205,4,231,235,6040,659,0
6/9/2021,Selangor,4124,4,320,324,1,451,452,2850,14,0
6/9/2021,Terengganu,2797,25,227,252,32,255,287,1745,191,0
6/9/2021,W.P. Labuan,251,0,5,5,0,0,0,31,8,0
7/9/2021,Johor,2578,1,258,259,2,264,266,1746,4,0
7/9/2021,Kedah,826,0,115,115,0,78,78,448,0,0
7/9/2021,Kelantan,3167,1,261,262,1,188,189,2120,17,0
7/9/2021,Melaka,1501,0,111,111,0,65,65,907,0,0
7/9/2021,Negeri Sembilan,2104,0,33,33,0,84,84,419,0,0
7/9/2021,Pahang,4265,14,249,263,12,271,283,2776,83,0
7/9/2021,Perak,1444,0,163,163,0,46,46,812,0,101
7/9/2021,Perlis,214,0,7,7,0,13,13,126,4,0
7/9/2021,Pulau Pinang,1895,0,138,138,0,100,100,702,0,0
7/9/2021,Sabah,5319,16,542,558,9,392,401,3028,111,0
7/9/2021,Sarawak,9818,9,191,200,4,183,187,6128,780,0
7/9/2021,Selangor,4124,5,298,303,1,428,429,2755,0,0
7/9/2021,Terengganu,2797,22,266,288,51,300,351,1711,162,0
7/9/2021,W.P. Labuan,251,2,2,4,2,0,2,30,8,0
8/9/2021,Johor,2578,2,514,516,1,361,362,1894,3,8
8/9/2021,Kedah,826,0,126,126,0,70,70,499,0,0
8/9/2021,Kelantan,3167,1,334,335,3,241,244,2178,6,0
8/9/2021,Melaka,1501,0,126,126,0,103,103,930,0,0
8/9/2021,Negeri Sembilan,2104,0,22,22,0,83,83,355,0,0
8/9/2021,Pahang,4265,18,418,436,10,253,263,2788,86,0
8/9/2021,Perak,1444,0,172,172,0,51,51,837,0,91
8/9/2021,Perlis,214,1,7,8,0,39,39,102,14,0
8/9/2021,Pulau Pinang,1895,0,104,104,0,86,86,711,0,0
8/9/2021,Sabah,5347,28,503,531,8,359,367,3130,133,0
8/9/2021,Sarawak,10154,7,224,231,0,151,151,6370,768,0
8/9/2021,Selangor,4124,12,458,470,2,446,448,2793,26,0
8/9/2021,Terengganu,2797,42,295,337,57,407,464,1598,147,0
8/9/2021,W.P. Labuan,251,0,5,5,0,0,0,35,7,0
9/9/2021,Johor,2582,3,349,352,1,252,253,1976,5,15
9/9/2021,Kedah,826,0,82,82,0,90,90,486,0,0
9/9/2021,Kelantan,3167,3,304,307,2,340,342,2130,8,10
9/9/2021,Melaka,1501,0,68,68,0,126,126,872,0,0
9/9/2021,Negeri Sembilan,2104,0,43,43,0,94,94,307,0,0
9/9/2021,Pahang,3675,18,359,377,3,318,321,2786,99,0
9/9/2021,Perak,1444,0,153,153,0,25,25,885,0,101
9/9/2021,Perlis,214,0,12,12,0,16,16,106,8,0
9/9/2021,Pulau Pinang,1895,0,118,118,0,92,92,713,0,0
9/9/2021,Sabah,5347,20,434,454,11,371,382,3124,136,0
9/9/2021,Sarawak,10154,4,136,140,1,153,154,6434,853,0
9/9/2021,Selangor,4114,4,434,438,1,409,410,2830,20,0
9/9/2021,Terengganu,2797,36,231,267,23,314,337,1515,160,0
9/9/2021,W.P. Labuan,251,13,10,23,1,0,1,42,19,0
10/9/2021,Johor,2582,1,294,295,2,231,233,2035,4,14
10/9/2021,Kedah,826,0,88,88,0,63,63,506,0,0
10/9/2021,Kelantan,3017,1,295,296,1,286,287,2120,8,9
10/9/2021,Melaka,1501,0,90,90,0,105,105,857,0,0
10/9/2021,Negeri Sembilan,2104,0,26,26,0,70,70,259,0,0
10/9/2021,Pahang,3675,20,368,388,9,284,293,2828,110,0
10/9/2021,Perak,1412,0,113,113,0,132,132,843,0,66
10/9/2021,Perlis,334,2,16,18,0,20,20,113,11,0
10/9/2021,Pulau Pinang,1895,0,75,75,0,66,66,735,0,0
10/9/2021,Sabah,5011,23,411,434,9,388,397,3152,130,0
10/9/2021,Sarawak,10256,4,192,196,61,170,231,6437,748,0
10/9/2021,Selangor,4114,5,402,407,2,464,466,2808,0,0
10/9/2021,Terengganu,2797,25,335,360,31,242,273,1608,154,0
10/9/2021,W.P. Labuan,251,5,4,9,0,0,0,43,24,0
11/9/2021,Johor,2582,2,223,225,1,303,304,1938,5,14
11/9/2021,Kedah,826,0,90,90,0,109,109,490,0,0
11/9/2021,Kelantan,3017,4,308,312,2,263,265,2136,10,0
11/9/2021,Melaka,1501,0,87,87,0,96,96,848,0,0
11/9/2021,Negeri Sembilan,1240,0,55,55,0,79,79,235,0,0
11/9/2021,Pahang,3675,14,243,257,7,254,261,2860,114,0
11/9/2021,Perak,1444,0,100,100,0,40,40,859,0,86
11/9/2021,Perlis,334,3,17,20,1,15,16,118,9,0
11/9/2021,Pulau Pinang,1895,0,118,118,0,93,93,763,0,0
11/9/2021,Sabah,5011,27,342,369,6,406,412,3063,138,0
11/9/2021,Sarawak,10256,6,155,161,2,131,133,6553,722,0
11/9/2021,Selangor,4114,5,432,437,2,407,409,2836,0,0
11/9/2021,Terengganu,2797,41,352,393,28,290,318,1670,167,0
11/9/2021,W.P. Labuan,251,4,2,6,1,0,1,41,27,0
12/9/2021,Johor,2582,0,318,318,0,250,250,1991,5,14
12/9/2021,Kedah,826,0,102,102,0,101,101,488,0,0
12/9/2021,Kelantan,3017,1,288,289,2,317,319,2113,8,0
12/9/2021,Melaka,1501,0,106,106,0,17,17,858,0,0
12/9/2021,Negeri Sembilan,1240,0,30,30,0,36,36,228,0,0
12/9/2021,Pahang,3675,16,342,358,6,294,300,3109,126,0
12/9/2021,Perak,1444,0,75,75,0,65,65,819,0,82
12/9/2021,Perlis,334,11,9,20,0,22,22,118,19,0
12/9/2021,Pulau Pinang,1895,0,127,127,0,106,106,772,0,0
12/9/2021,Sabah,5011,24,407,431,19,454,473,3087,129,0
12/9/2021,Sarawak,10256,9,210,219,1,225,226,6377,717,0
12/9/2021,Selangor,4114,4,369,373,55,399,454,2762,52,0
12/9/2021,Terengganu,2797,38,257,295,57,289,346,1637,148,0
12/9/2021,W.P. Labuan,251,16,1,17,3,0,3,32,40,0
13/9/2021,Johor,2582,1,330,331,0,203,203,2116,6,15
13/9/2021,Kedah,826,0,85,85,0,79,79,492,0,0
13/9/2021,Kelantan,3017,4,267,271,3,263,266,2092,9,0
13/9/2021,Melaka,1501,0,80,80,0,111,111,827,0,0
13/9/2021,Negeri Sembilan,1240,0,31,31,0,56,56,202,0,0
13/9/2021,Pahang,4271,13,407,420,6,257,263,3240,128,0
13/9/2021,Perak,1444,0,72,72,0,45,45,756,0,90
13/9/2021,Perlis,334,8,22,30,0,13,13,128,18,0
13/9/2021,Pulau Pinang,1895,0,88,88,0,82,82,721,0,0
13/9/2021,Sabah,5057,10,282,292,6,405,411,2922,116,0
13/9/2021,Sarawak,10256,5,220,225,7,222,229,6438,640,0
13/9/2021,Selangor,4114,1,267,268,0,464,464,2565,0,0
13/9/2021,Terengganu,2797,25,281,306,26,204,230,1714,147,0
13/9/2021,W.P. Labuan,251,0,10,10,0,0,0,39,36,0
14/9/2021,Johor,2582,2,240,242,1,165,166,2182,7,15
14/9/2021,Kedah,826,0,90,90,0,95,95,475,0,0
14/9/2021,Kelantan,2987,0,267,267,0,192,192,2146,9,0
14/9/2021,Melaka,1501,0,63,63,0,38,38,852,0,0
14/9/2021,Negeri Sembilan,1100,0,20,20,0,0,0,186,0,0
14/9/2021,Pahang,4471,6,371,377,5,217,222,3296,105,0
14/9/2021,Perak,1444,0,80,80,0,56,56,719,0,83
14/9/2021,Perlis,334,11,15,26,0,14,14,146,11,0
14/9/2021,Pulau Pinang,1905,0,88,88,0,61,61,747,0,0
14/9/2021,Sabah,5057,9,336,345,5,397,402,2771,101,0
14/9/2021,Sarawak,10203,2,230,232,1,146,147,6488,557,0
14/9/2021,Selangor,4114,4,281,285,1,414,415,2450,20,0
14/9/2021,Terengganu,2797,27,245,272,18,212,230,1747,156,0
14/9/2021,W.P. Labuan,251,0,1,1,3,0,3,35,32,0
15/9/2021,Johor,2398,1,203,204,0,118,118,2069,6,15
15/9/2021,Kedah,826,0,105,105,0,86,86,479,0,0
15/9/2021,Kelantan,2987,3,289,292,4,275,279,2151,8,0
15/9/2021,Melaka,1501,0,92,92,0,94,94,850,0,0
15/9/2021,Negeri Sembilan,1464,0,25,25,0,8,8,201,0,0
15/9/2021,Pahang,4471,8,366,374,9,263,272,3506,125,0
15/9/2021,Perak,1444,0,84,84,0,93,93,658,0,87
15/9/2021,Perlis,334,2,9,11,0,32,32,137,12,0
15/9/2021,Pulau Pinang,1905,0,111,111,0,70,70,776,0,0
15/9/2021,Sabah,5057,34,384,418,7,417,424,2778,128,0
15/9/2021,Sarawak,10313,7,212,219,0,169,169,6472,528,0
15/9/2021,Selangor,4114,5,354,359,3,372,375,2466,22,0
15/9/2021,Terengganu,2797,36,164,200,36,255,291,1656,156,0
15/9/2021,W.P. Labuan,251,4,0,4,1,0,1,33,35,0
16/9/2021,Johor,2398,0,124,124,3,129,132,2061,3,2
16/9/2021,Kedah,826,0,97,97,0,100,100,463,0,0
16/9/2021,Kelantan,2987,2,336,338,4,374,378,2106,8,0
16/9/2021,Melaka,1351,0,37,37,0,72,72,780,0,0
16/9/2021,Negeri Sembilan,1464,0,85,85,0,53,53,232,0,0
16/9/2021,Pahang,4471,7,384,391,5,298,303,3659,126,0
16/9/2021,Perak,1444,0,108,108,0,36,36,621,0,100
16/9/2021,Perlis,334,6,17,23,4,17,21,135,11,0
16/9/2021,Pulau Pinang,1905,0,115,115,0,114,114,782,0,0
16/9/2021,Sabah,4957,30,334,364,11,377,388,2675,134,0
16/9/2021,Sarawak,10413,2,163,165,2,168,170,6326,563,0
16/9/2021,Selangor,4062,7,420,427,8,351,359,2538,52,0
16/9/2021,Terengganu,2797,30,233,263,36,302,338,1587,150,0
16/9/2021,W.P. Labuan,251,0,8,8,0,0,0,36,31,0
17/9/2021,Johor,2398,0,206,206,0,212,212,2059,3,8
17/9/2021,Kedah,826,0,90,90,0,65,65,479,0,0
17/9/2021,Kelantan,2987,2,323,325,1,325,326,2087,9,0
17/9/2021,Melaka,1501,0,39,39,0,121,121,722,0,0
17/9/2021,Negeri Sembilan,1464,0,42,42,0,34,34,239,0,0
17/9/2021,Pahang,4471,12,336,348,7,358,365,3650,121,0
17/9/2021,Perak,1444,0,112,112,0,43,43,647,0,96
17/9/2021,Perlis,334,0,4,4,2,24,26,115,7,0
17/9/2021,Pulau Pinang,1905,0,180,180,0,95,95,820,0,0
17/9/2021,Sabah,4957,17,350,367,7,368,375,2611,135,0
17/9/2021,Sarawak,10233,8,226,234,2,243,245,6154,532,0
17/9/2021,Selangor,4062,0,356,356,4,443,447,2485,15,0
17/9/2021,Terengganu,2797,24,179,203,37,272,309,1494,135,0
17/9/2021,W.P. Labuan,251,0,2,2,8,0,8,35,23,0
18/9/2021,Johor,2398,0,143,143,1,73,74,2123,2,8
18/9/2021,Kedah,826,0,68,68,0,71,71,466,0,0
18/9/2021,Kelantan,2987,1,250,251,0,257,257,2068,8,0
18/9/2021,Melaka,1501,0,90,90,0,72,72,737,0,0
18/9/2021,Negeri Sembilan,1464,0,43,43,0,59,59,223,0,0
18/9/2021,Pahang,4471,9,128,137,16,145,161,3610,78,0
18/9/2021,Perak,1444,0,113,113,0,44,44,664,0,82
18/9/2021,Perlis,334,1,16,17,0,19,19,117,7,0
18/9/2021,Pulau Pinang,1905,0,112,112,0,75,75,845,0,0
18/9/2021,Sabah,4957,14,340,354,11,342,353,2620,128,0
18/9/2021,Sarawak,10413,14,169,183,1,234,235,5781,527,0
18/9/2021,Selangor,4062,4,248,252,0,360,360,2381,17,0
18/9/2021,Terengganu,2917,29,175,204,17,272,289,1397,149,0
18/9/2021,W.P. Labuan,251,3,1,4,4,0,4,28,22,0
19/9/2021,Johor,2398,1,163,164,1,166,167,2109,1,8
19/9/2021,Kedah,826,0,54,54,0,80,80,429,0,0
19/9/2021,Kelantan,2987,1,286,287,4,253,257,2076,9,0
19/9/2021,Melaka,1501,0,97,97,0,54,54,780,0,0
19/9/2021,Negeri Sembilan,1464,0,41,41,0,43,43,217,0,0
19/9/2021,Pahang,4871,11,457,468,11,214,225,3764,113,0
19/9/2021,Perak,1444,0,90,90,0,89,89,649,0,86
19/9/2021,Perlis,334,2,1,3,0,21,21,99,8,0
19/9/2021,Pulau Pinang,1905,0,130,130,0,111,111,844,0,0
19/9/2021,Sabah,4957,17,301,318,14,378,392,2571,118,0
19/9/2021,Sarawak,9336,8,197,205,1,244,245,5298,476,0
19/9/2021,Selangor,3992,4,258,262,0,376,376,2254,19,19
19/9/2021,Terengganu,3102,14,144,158,24,229,253,1490,146,0
19/9/2021,W.P. Labuan,251,0,0,0,4,0,4,27,18,0
20/9/2021,Johor,2398,0,196,196,0,273,273,2031,1,8
20/9/2021,Kedah,826,0,74,74,0,92,92,404,0,0
20/9/2021,Kelantan,2987,2,258,260,0,275,275,2067,11,0
20/9/2021,Melaka,1501,0,71,71,0,93,93,758,0,0
20/9/2021,Negeri Sembilan,1464,0,16,16,0,46,46,187,0,0
20/9/2021,Pahang,4871,15,311,326,5,306,311,3724,126,0
20/9/2021,Perak,1444,0,103,103,0,84,84,638,0,89
20/9/2021,Perlis,334,0,12,12,2,17,19,95,3,0
20/9/2021,Pulau Pinang,1905,0,114,114,0,105,105,809,0,0
20/9/2021,Sabah,4757,13,294,307,3,354,357,2421,113,0
20/9/2021,Sarawak,9177,11,167,178,0,234,234,5116,428,0
20/9/2021,Selangor,3992,0,188,188,2,340,342,2113,14,0
20/9/2021,Terengganu,3008,18,105,123,32,249,281,1346,132,0
20/9/2021,W.P. Labuan,251,0,0,0,5,0,5,25,13,0
21/9/2021,Johor,2648,4,228,232,1,288,289,1966,4,7
21/9/2021,Kedah,826,0,78,78,0,92,92,379,0,0
21/9/2021,Kelantan,2987,2,237,239,3,199,202,2093,10,0
21/9/2021,Melaka,1501,0,76,76,0,86,86,745,0,0
21/9/2021,Negeri Sembilan,1464,0,27,27,0,25,25,189,0,0
21/9/2021,Pahang,4871,16,384,400,19,389,408,3616,135,0
21/9/2021,Perak,1444,0,92,92,0,79,79,639,0,100
21/9/2021,Perlis,334,4,2,6,0,29,29,79,7,0
21/9/2021,Pulau Pinang,1905,0,75,75,0,72,72,830,0,0
21/9/2021,Sabah,4571,17,290,307,6,307,313,2453,116,0
21/9/2021,Sarawak,9207,4,186,190,3,221,224,4831,322,0
21/9/2021,Selangor,3992,3,220,223,2,310,312,2037,12,0
21/9/2021,Terengganu,3008,27,141,168,21,230,251,1256,138,0
21/9/2021,W.P. Labuan,251,3,1,4,4,0,4,21,12,0
22/9/2021,Johor,2648,2,240,242,0,325,325,1868,6,4
22/9/2021,Kedah,826,0,82,82,0,68,68,386,0,0
22/9/2021,Kelantan,2692,6,265,271,2,234,236,2084,14,0
22/9/2021,Melaka,1501,0,81,81,0,89,89,737,0,0
22/9/2021,Negeri Sembilan,1464,0,25,25,0,16,16,198,0,0
22/9/2021,Pahang,4871,19,352,371,10,399,409,3640,141,0
22/9/2021,Perak,1444,0,67,67,0,74,74,625,0,89
22/9/2021,Perlis,334,5,13,18,1,13,14,84,2,0
22/9/2021,Pulau Pinang,1905,0,123,123,0,93,93,778,0,0
22/9/2021,Sabah,4571,24,269,293,15,291,306,2435,106,0
22/9/2021,Sarawak,9307,55,160,215,5,140,145,4693,451,0
22/9/2021,Selangor,3992,2,259,261,0,332,332,1978,16,0
22/9/2021,Terengganu,3008,23,151,174,28,224,252,1183,133,0
22/9/2021,W.P. Labuan,251,0,2,2,2,0,2,15,8,0
